njengalo	ADV
nakwezinkulu	ADV
nobundlobongela	ADV
nezikolo	ADV
ezibameleyo	REL
kwiimveliso	NLOC
siza	VAUX
wedayagram	POSS03
i-south	N09
emini	NLOC
nolamlo	ADV
ongeza	V
sweleka	V
ngokupheleleyo	ADV
oshishino	REL
zokubhexesha	POSS08
elibonakalayo	REL
eyenziwa	REL
ezingaphantsi	REL
nemigaqo-nkqubo	ADV
nokusasazeka	ADV
gcina	V
nokwamkela	ADV
kwiiplothi	NLOC
ukukhethwa	N15
zobomi	POSS10
ejongwa	REL
matrix	FOR
abemali	REL
kwimicimbi	NLOC
epheleleyo	REL
nezehlo	ADV
osecaleni	REL
intsebenziswano	N09
abanxulumene	REL
mngeni	N03
nesabelo	ADV
anenkxalabo	REL
unomsebenzi	COP
yophengululo	POSS09
okuqhubekekayo	REL
nokucacisa	ADV
yiforam	COP
asisiseko	REL
sonikezelo	POSS07
kumashumi	NLOC
kwezincedisi	POSS15
lwamathuba	POSS11
qwalasela	V
i-seymour	N09
samaxesha	POSS07
engacingelwanga	REL
erichards	NLOC
nikela	V
xhasa	V
zimvo	N10
qatha	IDEO
unoluntu	COP
yoko	POSS09
nakwimibandela	ADV
nemikhwa	ADV
ezazibhalwe	REL
njengothungelwano	ADV
kwabathathu	ADJLOC
ingabi	COP
kwisakhiwo	NLOC
nkonzo	N09
ijelo	N05
lumandundu	COP
gqugula	V
abangamabhinqa	REL
oluyenzayo	REL
abakwaziyo	REL
nakwimisebenzi	ADV
izakhiwo	N08
kwenqanam	POSS15
esisisininzi	REL
wemicimbi	POSS01
nemimiselo	ADV
ezinikwa	REL
zokuzigwagwisa	POSS08
lusoloko	VAUX
kuphando	NLOC
yoorhulumente	POSS09
neenkolelo	ADV
lwayo	POSS11
property	FOR
olwenziwa	REL
ezingenasiseko	REL
lwawo	POSS11
zamashishini	POSS10
2000	NUM
zalathisi	N08
okunokubakho	REL
ngingqi	N09
ekuhleni	NLOC
unobhala	N01a
linqanam	COP
ziyintoni	COP
elithi	REL
njengomjikelo	ADV
qulatha	V
ziimpembelelo	COP
1999	NUM
lweencwadi	POSS11
kunokhuseleko	ADV
kungaba	CONJ
nomfanekiso	ADV
ngokuxhomekeke	ADV
kwiiseshoni	NLOC
mangala	V
nayikhabhinethi	ADV
indlela	N09
kubuchwepheshe	NLOC
kweenkonzo	POSS15
nokuthunyelwa	ADV
neenzuzo	ADV
njengeyamadoda	ADV
zangaphambili	ADV
njengowona	ADV
emfundo	POSS06
ubuchule	N14
ncamathisela	V
inamagunya	COP
engalungelelananga	REL
uvavanyo	N11
lokuchwetheza	POSS11
ezisebenza	REL
nakukhenketho	ADV
oyena	PROEMP01
yeyona	COP
ekufuneka	REL
esitalatweni	NLOC
ambalwa	REL
ziintsuku	COP
abasebenzi	N02
nodederhu	ADV
zasekhaya	POSS08
banesakhelo	COP
nezintlu	ADV
nge-idp	ADV
nowamaphondo	ADV
lomzantsi	POSS11
eliphina	REL
nekontrakthi	ADV
nakwimithetho-siseko	ADV
kooceba	NLOC
anendima	REL
esishwankathela	REL
yasemzantsi	POSS09
lokwenzeka	POSS05
yokugqibezela	POSS09
ezingaphandle	REL
ezomeleziweyo	REL
nkqubo	N09
zongenelelo	POSS10
weziphumo	POSS03
kubulungisa	NLOC
ukungabi	COP
isicwangciso-qhinga	N07
zeendawo	POSS10
engatsalela	REL
yokundulula	POSS09
nasekuphuculeni	ADV
ngamabakala	COP
wesikolo	POSS03
nakwiyantlukwano	ADV
wohlahlo	POSS03
eyahlukeneyo	REL
nobudlelane	COP
eliziphawulileyo	REL
imizobo	N04
eqhubayo	REL
qatshela	V
ezisentloko	REL
yebakala	POSS09
yinene	COP
ngokuncomekayo	ADV
abadlali-ndima	N02
elifanayo	REL
iiyantlukwano	N10
elide	ADJ05
wama-25	POSS03
luluvo	COP
linako	COP
izalathisi	N08
neengxelo	ADV
ngethuba	ADV
okwandayo	REL
nasekwandiseni	ADV
kwizibuko	NLOC
xilonga	V
inkathalo	N09
systems	FOR
jikela	V
olunkcenkceshelwayo	REL
zesadc	POSS10
elingundoqo	REL
yepotfoliyo	POSS09
okutsha	ADJ15
olusuka	REL
ezinogunyaziwe	REL
iiprojekthi	N10
kwababhexeshi	POSS15
avumileyo	REL
kubelula	COP
zewadi	POSS10
tyhala	V
esiphezulu	REL
ecetywayo	REL
izigaba	N08
i-mfma	N09
zokunikwa	POSS10
ngoncedo	ADV
i-11	N09
zenkqubela-phambili	POSS08
bambezela	V
ngokokushiyana	ADV
sesixa-mali	POSS07
negcinakalayo	ADV
ikomiti	N09
nahloniphekileyo	ADV
nolandelelwano	ADV
kwemiba	POSS15
kumakhosikazi	NLOC
ngcinga	N09
ngeengxaki	ADV
benguquko	POSS02
ubunzima	N14
yinxalenye	COP
iindawo	N10
wamakhosikazi	POSS03
kwisiza	NLOC
njl.njl.	ABBR
lwamagama	POSS11
ngokhathalelo	ADV
abamnyama	REL
amaninzi	ADJ06
okuvela	REL
kucwangciso	NLOC
shwankathela	V
inkunkuma	N09
kwemisebenzi	POSS15
afanele	REL
iingqiqo	N10
ezamkelekayo	REL
wemizuzu	POSS03
kwiikomitana	NLOC
esi-1.25	REL
nama-60%	ADV
namanqanaba	ADV
ga	IDEO
semandleni	NLOC
ngokoluvo	ADV
kulula	COP
tya	V
kwemikhosi	POSS15
yebhunga	POSS04
inkqubo-sikhokelo	N09
nakumacandelo	ADV
sizathu	N07
kulo	PROEMPLOC
umfanekiso	N03
noomasipala	ADV
yeqela	POSS09
kwethuba	POSS15
enobulunga	REL
amavolontiya	N06
nemithi	ADV
enokufunyanwa	REL
rates	FOR
anjengokumiswa	REL
lobomi	POSS05
usetyenziso	N11
isishwankathelo	N07
ezichongwe	REL
yeekomishoni	POSS09
ezihlanganisiweyo	REL
plan	FOR
acace	REL
kwi-pcm	NLOC
nokusetyenzwa	ADV
kusomlomo	NLOC
langoku	POSS05
kwizintlu	NLOC
umgqalelo	N03
okwamkela	POSS06
ali-10	REL
akumanqanaba	REL
orhwaphilizo	POSS06
nxaxheba	N09
neenkangeleko	ADV
ezindlwini	NLOC
kukarhulumente	POSS15
zemizuzu	POSS10
zimandundu	REL
ezimiswe	REL
ngo-2000	ADV
xola	V
lee-kpi	POSS05
nezopolitiko	ADV
angumsebenzi	REL
obaziyo	REL
enomsebenzi	REL
emakhayeni	NLOC
inoluhlu	COP
khathala	V
zokulinganisa	POSS08
zincediso	N08
engummangaliso	REL
lweemfuno	POSS11
bucala	ADV
ngemali	ADV
kwamagosa	POSS15
kwezixhobo	POSS15
nasekuyileni	ADV
oluncomekayo	REL
bezentlalo	POSS14
olulolwabo	REL
eengxoxo	POSS06
ababelwe	REL
eluxanduva	REL
ngumncedi	COP
ngabahlali	ADV
babameleyo	REL
ezizingela	REL
njengophuhliso	ADV
kubakho	COP
yenzuzo	POSS09
esilandelayot	REL
qhagamshela	V
zamasebe	POSS10
elahlukeneyo	REL
kumtla	NLOC
projector	FOR
lempilo	POSS05
nangenkqubo	ADV
abathweswe	REL
kpis	ABBR
ukhenketho	N11
nasiphi	ADV
oluyinene	REL
poa	ABBR
zola	V
handbook	FOR
zamaziko	POSS10
nokuquka	ADV
ezinikezelwa	REL
sesithuba	POSS07
ezisekele	REL
bokunxibelelana	POSS14
anobuntununtunu	REL
neyona	ADV
nengxaki	ADV
kwiyantlukwano	NLOC
iimfuneko	N10
lwembuyekezo	POSS11
lwamaphandle	POSS11
into	N09
abathwaxwa	REL
ezinokubakho	REL
ngeziqulatho	ADV
sempumelelo	POSS07
mhlawumbi	ADV
banelizwi	COP
esiluncedo	REL
ingcono	REL
nokucukulwa	ADV
ezichaseneyo	REL
okuneempembelelo	REL
zokuthatha	POSS10
nomgaqo-nkqubo	ADV
tshiphu	ADV
sishwankathelo	N07
angalonwabeliyo	REL
olukhula	REL
yeengingqi	POSS04
ngamathuba	ADV
elinikiweyo	REL
ngokufaka	ADV
ngokungathathi	ADV
isiqhamo	N07
nobonxulumano	ADV
kwamava	POSS15
unomthetho	COP
ziba	COP
mijikelo	N04
eziboniswe	REL
nenyathelo	ADV
yale	POSS09
umncinane	ADJ03
amatyala	N06
ophambili	REL
iitapile	N10
kutyalo-mali	NLOC
nokuhlola	ADV
lukamasipala	POSS11
lweenkcukacha	POSS11
okungalalalaliyo	REL
ezingagcinekanga	REL
lokusenza	POSS11
abazinikelayo	REL
lwezoqoqosho	POSS11
urhwebo	N11
nokufaka	ADV
iingxelo	N10
lokulindela	POSS05
lokubiza	POSS11
kwiinkokeli	NLOC
ngqalelo	N09
ngokufanayo	ADV
kweeyantlukwano	POSS15
umzi	N03
imicimbi	N04
ezizinzileyo	REL
liphupha	COP
babasebenzi	POSS02
nelizwe	ADV
yomsebenzisi	POSS04
tshitshilili	IDEO
isalathisi	N07
elingalunganga	REL
lokuvula	POSS05
yingqeqesho	COP
elidlulileyo	REL
kweekhontrakthi	POSS15
bangabaluphi	COP
lilandelayo	REL
kokungafani	POSS15
nesigwebo	ADV
khulula	V
yehiv	POSS09
chule	V
nenkxaso-mali	ADV
ngenjongo	ADV
ekumele	REL
ezixhasa	REL
wawo	POSS01
ngesantya	ADV
sakho	POSS07
nabalimi	ADV
ngokupapasha	ADV
njengokuba	ADV
tyalo-mali	N00
abasemagunyeni	REL
lokwazisa	POSS05
okusebenza	POSS06
zabucala	POSS10
siba	COP
eyodwa	REL
ngokwemigqaliselo	ADV
kwezentlalo	POSS15
nengingqi	ADV
nezinye	ADV
inginginya	N09
elizaliswe	REL
imiboniso	N04
umlinganiselo	N03
kwemali	POSS15
kungahle	VAUX
phazama	V
ne-4	ADV
yangaphambili	POSS09
septemba	NPP
kwisivumelwano	NLOC
ingxaki	N09
ngasentla	ADV
kwengxowa-mali	POSS15
nezimiselo	ADV
kwakhona	ADV
nabacinga	ADV
wokuhlonitshwa	POSS03
national	FOR
ezikhulisela	REL
kungeepowusta	COP
amacwecwe	N06
izikhundla	N08
bona	V
ezenziwe	REL
yokukhetha	POSS04
kuqukuqelo	NLOC
ngengxaki	ADV
amatsha	ADJ06
)	PUNC
olubanzi	REL
yocalucalulo	POSS09
nakuluntu	ADV
umxolelanisi	N01
nephakathi	ADV
kweyona	POSS15
babe	VAUX
wemali	POSS03
we-5	POSS03
imigca	N04
nequmrhu	ADV
nezirhwetywa	ADV
lwemeko	POSS11
ezinegalelo	REL
luncedo	COP
zokunyulwa	POSS08
webhunga	POSS03
nge-swot	ADV
kwingqesho	NLOC
ziingcaphephe	COP
abc	ABBR
nabalawuli	ADV
ofakelweyo	REL
nenzame	ADV
wethutyana	POSS01
nayo	ADV
ezayo	REL
esisekwe	REL
a	ABBR
sokufumanisa	POSS07
lwemibuzo	POSS11
nokuphengulula	ADV
sikhona	ADV
isiqendu	N07
khokela	V
unendima	COP
zililizwi	COP
eqhutywa	REL
ezisezantsi	REL
hlalutya	V
yeminyaka	POSS09
bebekuludwe	COP
yokufikelela	POSS04
ngokuthuma	ADV
aphuhlise	REL
nolwakhiwo-zindlu	ADV
yezinto	POSS04
owongeziweyo	REL
ngemithombo	ADV
yedwa	PROQUANT01
kwinkqubela	NLOC
olona	PROEMP11
weenkonzo	POSS03
lolwaphulo	POSS11
zezemfundo	POSS10
ephazamisayo	REL
baze	VAUX
i-100%	N09
nesenokuba	ADV
koku	ADVLOC
kwenqanaba	POSS15
bezabelo	POSS02
iikomiti	N10
ii-ngo	N10
okuxhasa	POSS06
eliphantse	REL
isoloko	ADV
elibalulekileyo	REL
okusebenzisana	REL
afundiwe	REL
zibini	COP
kwiintlanganiso	NLOC
enqila	POSS06
isemva	COP
thatha	V
enentsingiselo	REL
kwemigangatho	POSS15
idemokhrasi	N09
basekuhlaleni	POSS02
nomba	ADV
nangokwendlela	ADV
nangokunika	ADV
iyimfuneko	COP
sisifo	COP
sinamandla	COP
eninolwazi	REL
bexesha	POSS14
isandisi-sandi	N07
nemveliso	ADV
ngabathathi-nxaxheba	COP
bokunciphisa	POSS14
zokuhlangabezana	POSS10
ebengamahlanga	COP
enabanini	REL
iitrakhi	N10
besicwangciso-qhinga	POSS14
ngamacwecwe	ADV
wengxelo	POSS03
zenene	POSS08
ngemizekelo	ADV
umonde	N03
kumcimbi	NLOC
yexabiso	POSS04
mathuba	N06
ngokuhambelana	ADV
sothweso	POSS07
luya	VAUX
umncono	N03
umthetho	N03
isango	N05
lwe-sdip	POSS11
yokubandakanya	POSS09
njengabafumani	ADV
ngokumalunga	ADV
kukwakho	COP
ezidweliswe	REL
iimpiliso	N10
elitsha	ADJ05
kuqala	ADV
abanikezwe	REL
kumasebe	NLOC
ngokuvavanya	ADV
nasekuhleleni	ADV
sebenza	V
awohlukeneyo	REL
ilogframe	N09
iajenda	N09
anokuthi	REL
ke	CONJ
nelungelelaniswe	ADV
okungathembani	REL
khupha	V
umyinge	N03
ababona	REL
kwamaxesha	POSS15
ubundlobongela	N14
kwindima	NLOC
iinxenye	N10
kwingabula-zigcawu	NLOC
izimvo	N10
sokukhula	POSS07
nikezela	V
nelinamagunya	ADV
nezithuthi	ADV
nefuthe	ADV
ingaba	COP
thetha	V
yingxolo	COP
kwezomthetho	NLOC
zasesitalatweni	POSS08
ngokuthi	ADV
isithili	N07
oonobangela	N02a
i-ngo	N09
yokuphucula	POSS09
ka-1992	POSSKA
esikwiphepha	REL
nabengingqi	ADV
iziqulatho	N08
iziko	N05
ngemfundo	ADV
phumelela	V
sesixokelelwano	POSS07
ndim	COP
lungangumthundezi	COP
wegdp	POSS03
neqela	ADV
aya	VAUX
ububanzi	N14
izihlandlo	N08
bunzima	N14
izimali	N10
kwikholam	NLOC
encomekayo	REL
enokufumana	REL
beenkxaso-mali	POSS02
abakhulu	ADJ02
emandla	REL
olwenziwe	REL
modyuli	N00
27(4)	NUM
samaziko	POSS07
njengelizwe	ADV
kuthutho	NLOC
enkundleni	NLOC
iforam	N09
amaqalela	N06
ngokwengqiqo	ADV
kubume	NLOC
oye	REL
kwamadoda	POSS15
zokuthengiselana	POSS10
oluntu	POSS06
nesisekelwe	ADV
izikolo	N08
lezempilo	POSS05
abanokuhlangabezana	REL
asilohlahlo	COP
ekungabikhoni	ADVLOC
isaziso	N07
kwimfuno	NLOC
ovavanyo	POSS06
yase-asia	POSS09
sokola	V
kohanjiso	POSS15
38	NUM
lwangaphakathi	POSS11
locwangciso	POSS11
ezimana	REL
zizenzo	COP
asiyomeko	COP
siphezulu	ADV
ubujoni	N14
nomkhosi	ADV
abangama-3	REL
ikweli	REL
anyuliweyo	REL
ngemisetyenzana	ADV
revenue	FOR
nokunika	ADV
kwethu	POSS15
wabafundi	POSS03
nokungasebenzi	ADV
samalungu	POSS07
lweminyaka	POSS11
enyukayo	REL
esizikithini	NLOC
ngezolimo	ADV
esiyilwe	REL
zokugaya	POSS10
yi-idp	COP
obanzi	REL
olunempumelelo	REL
inkampani	N09
nelabucala	ADV
ezimiyo	REL
ngamanqanaba	COP
zokukwazi	POSS08
yokuziqhelanisa	POSS09
okuyinene	REL
kwamagama	POSS15
nobungcali	ADV
kasihlalo	POSS01
pakisha	V
gqolo	IDEO
ongakumbi	REL
neminye	ADV
jika	V
neentliziyo	ADV
salo	POSS07
nokunqwala	ADV
nasekapa	ADV
nokuzazi	ADV
yemfundo	POSS09
ephuhliswe	REL
abanehiv	REL
amqela	N06
namaphulo	ADV
eziphawulwe	REL
bokungeva	POSS14
iyonke	COP
ehlanganiselweyo	REL
elo	CDEM05
iphondo	N05
nokubanombono	ADV
ekhuphisanayo	REL
ezinokukhuthaza	REL
esigqityezelweyo	REL
yesizwangciso	POSS09
ezimanyanisiweyo	REL
wolungelelwano	POSS01
qhagamshelana	V
emisetyenzana	POSS06
neenkonzo	ADV
anonaniselwano	REL
zokhathalelo	POSS08
lokuthetha	POSS05
labahlawuli	POSS05
oyintloko	REL
okugqalisela	REL
miba	N04
ibinzana	N05
eziyithathayo	REL
zizezangaphandle	ADV
calucalula	V
vetshe	IDEO
noluphakathi	ADV
oluhleleleke	REL
engenabungozi	REL
amangenelelo	N06
zinza	V
ngegalelo	ADV
ngokuxoxa	ADV
maqonga	N06
azichaze	REL
evumela	REL
kugutyulo	NLOC
kwesabelo	POSS15
kumnyango	NLOC
wokulima	POSS03
kwinjineli	NLOC
nantsi	COP
yokuquka	POSS09
nesibandakanywe	ADV
ekunokufunyanwa	REL
okungokunye	REL
lwemo	POSS11
izisombululo	N08
mw	ABBR
bukazwelonke	POSS14
koomasipala	POSS15
wophando	POSS03
ngoovimba	ADV
yakutshanje	POSS04
abanobulunga	REL
uhlahlo	N11
namaqonga	ADV
obonisa	REL
eligcinakala	REL
yokuqhubekeka	POSS09
ubonelelo	N11
ngamaqondo	ADV
nocacisa	ADV
esibhalisiweyo	REL
ohlala	REL
nokuvumela	ADV
nombhexeshi	ADV
nangakumbi	ADV
nabaqeshwa	ADV
intsukaphi	N09
esiyilelwe	REL
amanqanaba	N06
amaqhezu	N06
oludityanelwayo	REL
usoloko	VAUX
elinendlwana	REL
komjikelo	POSS15
bahlelelekileyo	REL
abanoxanduva	REL
lohlahlo	POSS11
kwiiprojekthi	NLOC
bayinxalenye	COP
linga	V
kuyinkqubela-phambili	COP
kwiinguqu	NLOC
abawanikiweyo	REL
akanalungelo	COP
iziseko	N08
kwamakhulu	POSS15
lwentando	POSS11
yenjongo	POSS09
namabhinqa	ADV
olwenziweyo	REL
esimacala	REL
yolwazi	POSS04
yemisebenzi	POSS09
bokuphatha	POSS14
umsindo	N03
nakwizixhobo	ADV
lenkosikazi	POSS05
ququmbela	V
ezinxulumene	REL
ekhokelela	REL
nayiphi	ADV
nenkcubeko	ADV
ophengululo	REL
olwazi	POSS06
edolophu	POSS06
kombhexeshi	POSS15
alunakhuphiswano	COP
amagalelo	N06
sineendlela	COP
benxaxheba	POSS14
kwezintathu	ADJLOC
sophuhliso-buqili	POSS07
ezinyanisekisa	REL
seemveliso	POSS07
inempembelelo	COP
jolisa	V
elungelelanisiweyo	REL
nowiso-mthetho	ADV
nebango	ADV
zobunini	POSS10
achongiweyo	REL
yona	PROEMP04
nengqiqo	ADV
yobuthathaka	POSS09
yeentlobo	POSS09
asewadini	POSS06
nokusebenzisa	ADV
komkhondo	POSS15
luhlahlo-mali	COP
ulula	REL
kwiiyantlukwano	NLOC
kumntu	NLOC
lulwabiwo	COP
kweprojekthi	POSS15
yaseisulabasha	POSS09
isisombululo	N07
ayama	V
ukhathalelo	N11
umahlulelane	N01a
esikiweyo	REL
abazilindeleyo	REL
besithuba	POSS14
umzobo	N03
bokufunda	POSS14
lwehiv	POSS11
enceda	REL
umgaqo-nkqubo	N03
neenguqulelo	ADV
obunemveliso	REL
impilo	N09
kwiprowujekthi	NLOC
nenkqubela	ADV
kwesi	CDEMLOC
nesahluko	ADV
oza	REL
ngesishwankathelo	ADV
kwabalandelayo	POSS15
nakwiingxoxo	ADV
nababucala	ADV
umoya	N03
owona	PROEMP03
zemithombo	POSS10
abakwi-idp	REL
lowe-1998	POSS05
iliwa	N05
umnqophiso	N03
kuselithuba	COP
lokungafani	POSS11
zomthetho	POSS10
nabophuli-mthetho	ADV
nokuzimanya	ADV
nesihleliyo	ADV
nokuyilwa	ADV
-buqili	N14
nemali-mboleko	ADV
sabalala	V
njengoluvo	ADV
kwisikhundla	NLOC
eyimise	REL
nobuhlanga	ADV
umnikelo	N03
umane	VAUX
nangempumelelo	ADV
ngangeeyure	ADV
nezinga	ADV
thamba	V
fumaneka	V
empuma	NLOC
nokudluliswa	ADV
okungcolisa	REL
kulwenziwo	NLOC
zokubekwa	POSS10
nabo	ADV
yoxinzelelo	POSS09
lokufumana	POSS05
kumgaqo-nkqubo	NLOC
eyona	PROEMP09
olungacalucaluli	REL
kumyalelo	NLOC
lwetransparency	POSS11
nakwiinkqubo	ADV
ngesiphumo	ADV
abanako	REL
phumeza	V
kwiilali	NLOC
bhala	V
obubanzi	REL
ngokusekwa	ADV
gqithisa	V
neengcinga	ADV
nokukhulisa	ADV
balawula	REL
nasekukhangeleni	ADV
zendawo	POSS10
ulumano-ndlebe	N11
kwisithili	NLOC
angcono	REL
ubude	N14
municipal	FOR
lobunzima	POSS05
ngomhla	ADV
nto	N09
zaba	COP
ngokuthelekisa	ADV
yabaniki	POSS04
beenqila	POSS02
xoxa	V
sdip	ABBR
khalaza	V
zempumelelo	POSS10
abafazi	N02
ebevinjwe	REL
wokwandisa	POSS03
abaya	REL
iintlawulo	N10
olwenza	REL
zingaphantsi	COP
esilawulayo	REL
olukhoyo	REL
lokulinganisa	POSS05
okufunda	REL
i-swot	N09
zebhokisi	POSS10
sisivumelwano	COP
lamakhosikazi	POSS05
kwebakala	POSS15
olungachanekanga	REL
mthethweni	NLOC
othetha	REL
tshintshisa	V
yer&d	POSS09
eziwadini	NLOC
isifezekiso	N07
weenqobo	POSS03
zeziphatha-mandla	POSS10
siqingatha	N07
ebekhona	COP
kokungalingani	POSS15
yinyaniso	COP
ofumana	REL
kubatyali-mali	NLOC
obunganceda	REL
ngokuchaphazela	ADV
nodidi	ADV
abanyuliweyo	REL
ezihamba	REL
ngokwesini	ADV
igalelo	N05
amaqumrhu	N06
njengeekomiti	ADV
olungcono	REL
nkulu	ADJ09
ngokobudoda	ADV
eziyilwe	REL
lababhexeshi	POSS05
ngokokulawulwa	ADV
amaxesha	N06
vavanyo-zimvo	N11
buza	V
yezikhokelo	POSS09
ngawaphi	COP
wesicwangciso	POSS03
neyenza	ADV
yokuhamba	POSS04
lokulahlekelwa	POSS11
ngenkqubela	ADV
eyahluka-hlukeneyo	REL
ezikwinqanaba	REL
bane-ajenda	COP
ngamalungu	COP
eziphakanyisiweyo	REL
nokubonisa	ADV
nkalo	N10
okusombulula	POSS06
uhlengahlengiso	N11
kwiseshoni	NLOC
koququzelelo	POSS15
kwepolisi	POSS15
hlanganela	V
amanani	N06
ezinokufezekiseka	REL
ipasele	N09
uphuculo	N11
nokuseka	ADV
sothungelwano	POSS07
nobugcisa	ADV
elixutyaniswe	REL
yokuthatha	POSS04
charters	FOR
ezithile	REL
bendalo	POSS14
zezisombululo	POSS10
zeqela	POSS10
nokukhutshwa	ADV
iinqobo	N10
ekugqitywe	REL
enokundinceda	REL
lwasekhaya	POSS11
i-pms	N09
kwemithombo	POSS15
neziganeko	ADV
themba	V
adibana	REL
nesenzo	ADV
nonxibelelwano	ADV
omncinci	ADJ01
ezaneleyo	REL
okungeyomfuneko	REL
yohlaziyo	POSS09
iinkxalabo	N10
okazwelonke	REL
nokuthungelana	ADV
ne-ofisi	ADV
esikhokela	REL
nesini	ADV
quka	V
ukungabikho	COP
iinkolo	N10
nokuguqula	ADV
ekufutshane	REL
nonxweme	ADV
khapha	V
engamashumi	REL
yabantwana	POSS09
dolophu	N00
duba	V
egqibeleleyo	REL
nokwamadoda	ADV
thenga	V
ezikufutshane	REL
elongezelelekileyo	REL
evulekileyo	REL
iqhelekileyo	REL
okutya	POSS06
umnu	N01a
eliphendula	REL
bhekela	V
ehlabathini	NLOC
kwii-ambulensi	NLOC
yiprojekthi	COP
funa	V
wemizobo	POSS03
elibi	ADJ05
ngakwikomiti	ADV
cukuceza	V
sotyalo-mali	POSS07
kudala	ADV
eyakho	REL
iindidi	N10
nozwelonke	ADV
amazwe	N06
lwelizwe	POSS11
nakwindalo	ADV
lweenjongo	POSS11
ye-ajenda	POSS09
okucetyiswe	REL
kuninzi	ADJLOC
bakuba	VAUX
kwimibuzo	NLOC
ezibonisa	REL
lohlolo	POSS11
zedemokrasi	POSS08
nanjengoko	ADV
thothomala	V
ezifundo	POSS06
kwengama-24	NLOC
ingabikho	COP
nenokuthi	ADV
uxinezelelo	N11
wokukhathalela	POSS03
kunyaka	NLOC
lama-33	POSS05
esimandla	REL
ngomlomo	ADV
iinkokeli	N10
olulungele	REL
5	NUM
imijikelo	N04
zamaphondo	POSS10
omzimba	POSS06
yekomiti	POSS09
nekopi	ADV
ezidala	REL
lwewadi	POSS11
nolunentsebenziswano	ADV
nokunabisa	ADV
kwecandelo	POSS15
iingcali	N10
kumaziko	NLOC
owaziyo	REL
zuza	V
wenu	POSS01
nokhuseleko	ADV
nanini	ADV
ezininzi	ADJ10
ushishino	N11
abenzi	N02
zophuculo	POSS10
guda	V
kwengqondo	POSS15
intando	N09
seempahla	POSS07
ekubeni	CONJ
uxwebhu	N11
ezilolo	REL
luluntu	COP
yezezimali	POSS09
abahlukeneyo	REL
olululo	REL
zesithuthi	POSS08
neyezincedisi	ADV
eziphononongwe	REL
nelungu	ADV
balula	V
unomnikelo	COP
ngezindlu	ADV
lasekuhlaleni	POSS11
namele	ADV
kwekhabhondayoksayidi	POSS15
kwiimbono	NLOC
ezikude	ADJ10
seengcebiso	POSS07
nabanolwazi	ADV
ekwanoxanduva	REL
amabhinqa	N06
hlela	V
lolunye	COP
okhuphisanayo	REL
otyalo-mali	POSS06
lwemibutho	POSS11
kumbane	NLOC
nokomelezwa	ADV
iphulo	N09
yesikhundla	POSS09
nezalathiso	ADV
nakwiikomiti	ADV
kokungena	POSS15
ngokomzekelo	ADV
eyinzuzo	REL
neengcali	ADV
kumdla	NLOC
inkomfa	N09
abazidingayo	REL
nobume	ADV
ibhunga	N05
elisemaphandleni	REL
banemifuno	COP
kwisiqendu	NLOC
lwenyathelo	POSS11
zingumqobo	COP
exco	NPP
senkonzo	POSS07
solawulo	POSS07
ebalaseleyo	REL
kwezizwe	POSS15
kuxa	COP
lika-2030	POSS05
ngabanye	ADV
eziqhelekileyo	REL
zemvelaphi	POSS10
nama-300	ADV
zezibonelelo	POSS08
okhuphiswano	POSS06
kuvavanyo	NLOC
kuyo	PROEMPLOC
onikezelo	POSS06
womanyaniso	POSS06
nobuhlwempu	ADV
ezambuku	POSS06
zikhoyo	REL
kamongameli	POSSKA
ne-municipal	ADV
ezithi	REL
bobuhlwempu	POSS02
ebanzi	REL
oluqukayo	REL
njengemiba	ADV
kubuqhetseba	NLOC
wama-70	POSS03
nangokutshintshelwa	ADV
kweegesi	POSS15
bangaphi	COP
ka-1996	POSSKA
angaphambili	REL
onxibelelwano	POSS06
angumnqantsa	REL
nenzala	ADV
ubungqina	N14
ezinomxholo	REL
wokupheka	POSS03
hlula	V
ngumceli-mngeni	COP
yesixeko	POSS09
ngokoqoqosho	ADV
koko	CDEMLOC
ezingavelisi	REL
yokuvandlakanya	POSS09
abalulekileyo	REL
seeprojekthi	POSS07
nokumisa	ADV
nqanam	N05
zidingo	N08
womsindo	POSS01
nokunikezelwa	ADV
kwibakala	NLOC
abentetho-ntuthuzelo	REL
ngeminyaka	ADV
bomzimba	POSS14
ngokuphathelene	ADV
nakubomi	ADV
lama-28	POSS05
sosuleleko	POSS07
uhlambululo	N11
abaphila	REL
nezithungeleneyo	ADV
lwedolophu	POSS11
ugayo	N11
za	V
zotyelelo	POSS10
uwonke	PROQUANT03
uhlelo	N11
abamaqela	REL
isivumelwano	N07
nokulawulwa	ADV
kunaniselwano	NLOC
okuquka	REL
ezisetyenziswa	REL
kude	ADJLOC
yecandelo	POSS09
bezigqibo	POSS02
anako	COP
ezingazange	REL
lwezimvo	POSS11
banegalelo	COP
nokudala	ADV
nokufunekayo	ADV
komthwalo	POSS15
othembekileyo	REL
yehlabathi	POSS04
abaswele	REL
ngabathunywa	COP
okhulayo	REL
wamaxwebhu	POSS03
kumantla	ADVLOC
zolondolozo	POSS08
ipesenti	N09
aqukuqelayo	REL
abangasiwaso	REL
oluphuculweyo	REL
senkqubo-qhinga	POSS07
amatyeli	N06
ngubani	COP
yinzuzo	COP
nachazwe	ADV
isikhululo	N07
iintsapho	N10
kwinkcubeko	NLOC
nanza	V
zeziganeko	POSS08
lwepolitiki	POSS11
engalunganga	REL
oqatha	REL
eyibha-tshathi	REL
yasekhaya	POSS09
abanezakhono	REL
kumgaqo	NLOC
action	FOR
namabhunga	ADV
banothotho	COP
000	NUM
ngokobuhlanga	ADV
ngeeprojekthi	ADV
ngokunikwa	ADV
olusetyenziswa	REL
kwezenzululwazi	POSS15
abenza	REL
abanomdla	REL
ziyimpumelelo	COP
nentsingiselo	ADV
asililo	COP
and	FOR
lalo	POSS05
enjengokusilela	REL
olugcinekileyo	REL
neferokhrowum	ADV
ekufana	REL
lungumceli-mngeni	COP
ezinempembelelo	REL
obuphi	REL
nelifa	ADV
yokuhlola	POSS09
nyathela	V
kolutsha	POSS15
nengqesho	ADV
wesiqulatho	POSS03
neepowusta	ADV
lamanqaku	POSS05
ngowabo	COP
zamanyathelo	POSS08
nentsholongwane	ADV
lokunikezela	POSS11
iingcinga	N10
kwiimodeli	NLOC
ezaqaliswa	REL
obumiswe	REL
iikhontrakthi	N10
ngamanye	ADV
ezintathu	ADJ10
esikukhetha	REL
lwemithombo	POSS11
cinga	V
lwekhabhoni	POSS11
kwabo	POSS15
nasekufunzeni	ADV
32	NUM
nabathengi	ADV
sephepha	POSS07
oluneenkcukacha	REL
fihla	V
beengingqi	POSS02
isisiseko	COP
yento	POSS09
ukhona	COP
nezigqeba	ADV
nxulumano	N11
balisa	V
eswenikwinkqubo	NLOC
yokuqhuba	POSS09
engqalisiweyo	REL
zezo	POSS10
ochaziweyo	REL
eyimfuneko	REL
kwelama-76	NLOC
loomahlulelane	POSS11
kohlahlo-mali	POSS15
adweliswe	REL
yengingqi	POSS09
ophantsi	REL
eqale	REL
lokukhula	POSS05
qikelela	V
mabakala	N06
intlanganiso	N09
kwesinye	ADJLOC
kweminyaka	POSS15
kulawulo	NLOC
lezemisebenzi	POSS05
lobundlobongela	POSS05
lokubaluleka	POSS05
ngumzekelo	COP
kwi-afrika	NLOC
abazali	N02
kokuphumeza	POSS15
kumanxweme	NLOC
bamaziko	POSS14
xinana	V
yecbp	POSS09
koqeqesho	POSS15
izindululo	N08
ziphambili	ADV
nenokwenza	ADV
okusebenzayo	REL
lunxibelelwano	COP
abo	POSS06
zokuvumelana	POSS10
okuphumeza	POSS06
shushu	ADV
engaguqukiyo	REL
ilali	N05
namaceba	ADV
enyathelo	POSS07
alingohalala	COP
lwendleko	POSS11
kungumceli-mngeni	COP
ulutsha	ADJ11
ababasebenzelayo	REL
nokucebisa	ADV
emakhitshini	NLOC
elivisayo	REL
lokongeza	POSS05
kwizimbiwa	NLOC
lubuthathaka	COP
wenzuzo	POSS03
kungenelelo	NLOC
lemigodi	POSS05
urhulumente	N01a
sobutyebi	POSS07
wendalo	POSS03
engasentla	REL
olubona	REL
zekomiti	POSS08
lomntu	POSS05
nezoqoqosho	ADV
emininzi	ADJ04
wabo	POSS03
abanazo	REL
elilindelekileyo	REL
ngumntu	COP
yamathuba	POSS09
nyusa	V
ngokucothayo	ADV
ngelo	ADV
abathengisa	REL
ngokuzikisa	ADV
wobungakanani	POSS03
okutyisa	POSS06
xhomekeka	V
abaluleke	REL
isizwe	N07
umniki	N01
egumbini	NLOC
kumantombazana	NLOC
kwindawo	NLOC
neshishini	ADV
nexesha	ADV
kolu	CDEMLOC
ophathelele	REL
emi	REL
mawabe	COP
esandlala	REL
ngaphakathi	ADV
ekwiphepha	REL
kwishishini	NLOC
kwamabhunga	POSS15
wokuba	POSS03
le-smart	POSS05
akuyonto	COP
nokunceda	ADV
esisigxina	REL
nokusemthethweni	ADV
womvuzo	POSS01
abasebenzisa	REL
neengcebiso	ADV
imingeni	N04
ii-idp	N10
lwendalo	POSS11
ezidlalwa	REL
ngababhexeshi	COP
namanyathelo	ADV
kwinkxaso-mali	NLOC
alungeleyo	REL
nabathunywa	ADV
ngokunyulwa	ADV
inokubakho	COP
nezazisanayo	ADV
bomzantsi	POSS02
elizwe	POSS05
wa	V
lweengxaki	POSS11
nezicwangciso-qhinga	ADV
siseko	N07
yezomthetho	POSS09
indleko	N09
kwimpumelelo	NLOC
ezithathu	ADJ10
ikhontraka	N09
zoquko	POSS08
enyiniweyo	REL
nakwingingqi	ADV
kumanyathelo	NLOC
lokuqalisa	POSS05
aphuma	REL
yeziqhamo	POSS04
eyesibini	REL
zimali	COP
nengeniso	ADV
nekwazulu-natal	ADV
onomdla	REL
esigqeba	POSS06
icwecwe	N05
engakhange	REL
engakumbi	REL
kwigama	NLOC
wokungena	POSS03
umlilo	N03
yesi	POSS09
ikhonkco	N05
iithagethi	N10
unyimo	N11
soovimba	POSS07
onokuxabanisa	REL
abanomsindo	REL
ngokukhuthaza	ADV
yokusibhala	POSS09
ozisa	REL
lobuzaza	POSS05
likarhulumente	POSS05
nomhlophe	ADV
esifunekayo	REL
ongoxanduva	REL
ejongelwe	REL
juni	NPP
ikwayindlela	COP
bubume	COP
ngoluntu	ADV
uqoqosho	N11
usemgangathweni	COP
eli-10	REL
sinombono	COP
ezingangqinelaniyo	REL
nedityanelweyo	ADV
ulwahlulelwano	N11
lento	CDEM09
ezingoshishino	REL
abayenzileyo	REL
fakela	V
wamakhaya	POSS01
elisemva	REL
ngoobani	COP
abatshintshayo	REL
vela	V
abalithoba	REL
mofolo	NPP
enomtsalane	REL
uwodwa	PROQUANT03
kulwakhiwo-zindlu	NLOC
uphando	N11
no	ABBR
lula	ADV
ngokwekota	ADV
elilinganiselweyo	REL
nokuphuma	ADV
ocingwe	REL
kwiikona	NLOC
bekukho	COP
aziloqumrhu	COP
unelungelo	COP
ezinyanisekileyo	REL
phezu	ADV
ezakhiweyo	REL
sokhuseleko	POSS07
ebithe	REL
wasendlwini	POSS03
esikolweni	NLOC
okunganelisiyo	REL
okulolo	REL
baza	VAUX
ezingekasetyenzwa	REL
somgaqo-nkqubo	POSS07
lamandla	POSS05
iprojekthi	N09
yoogobityholo	POSS09
inzuzo	N09
neqabane	ADV
bukela	V
ngokufunda	ADV
azi	V
izikimu	N08
abafumana	REL
kuphantse	COP
bezigaba	POSS02
kwiholo	NLOC
yingcaphephe	COP
sotshintshiselwano	POSS07
abafuna	REL
lamana	V
yomnye	POSS09
yokufezekisiweyo	POSS09
fumanisa	V
amathandathu	ADJ06
ayikho	COP
kwamanye	POSS15
ematyotyombeni	NLOC
lweliso	POSS11
bokuzilungisa	POSS14
namalungiselelo	ADV
sisiphumo	COP
sobundlobongela	POSS07
esi-1	REL
nezinto	ADV
amancedo	N06
ezicacileyo	REL
18	NUM
yomndilili	POSS04
evoti	POSS01
kuphononongo	NLOC
zinamaqondo	COP
khumbuza	V
lengcaciso	POSS05
yokwenziwa	POSS09
nokufezekiswa	ADV
esekuhlaleni	REL
ezicuthiweyo	REL
inqanaba	N05
yobumelwane	POSS04
eyandisiweyo	REL
iiklinikhi	N10
kwiimpahla	NLOC
yokuzola	POSS09
yokusombulula	POSS09
kweempawu	POSS15
nehiv	ADV
ngabasebenzisi	COP
uthelekelelo	N11
luhlu	N11
nakwibhodi	ADV
ngeenkcukacha	ADV
chu	IDEO
engenzi	REL
yohlaza	POSS04
zinyanga	COP
yempumelelo	POSS09
kwinkonzo	NLOC
eyurophu	NLOC
seenkonzo	POSS07
okungazinzisiyo	REL
amashumi	N06
elichaphazelekayo	REL
okuhlanganelwayo	REL
ezingcono	REL
malungelo	N06
kumngcipheko	NLOC
sokuphelisa	POSS07
nokuvandlakanywa	ADV
enengeniso	REL
qulunqa	V
iminqweno	N04
kwabaniki-lukhathalelo	POSS15
namajelo	ADV
cape	NPP
nasekubetheleleni	ADV
eminyaka	POSS06
ebebeqeshe	REL
lwentsebenziswano	POSS11
cala	N00
conflictus	FOR
lwemida	POSS11
iimpazamo	N10
abayithethayo	REL
sokunika	POSS07
ngokwasemalini	ADV
abatsha	ADJ02
ezintlanu	ADJ10
ihlabathi	N05
yayi	VAUX
buyimpumelelo	COP
beekomiti	POSS02
ngo	ABBR
siye	VAUX
hlonela	V
fihlisa	V
kukawonke-wonke	POSS15
eziphakathi	REL
nabaniki	ADV
isifundo	N07
mamela	V
anayo	REL
kowona	ADVLOC
izithabazi	N08
kwisigqeba	NLOC
kwiimeko	NLOC
mahluko	N00
iikomitizeewadi	N10
nokuncitshiswa	ADV
uyintloko	COP
kwinxaxheba	NLOC
lweeprojekthi	POSS11
namonde	COP
oluhlanganyelweyo	REL
kwamasebe	POSS15
ngenkuthalo	ADV
oxanduva	POSS06
engingqi	POSS06
neentsana	ADV
ngokucacileyo	ADV
esihle	ADJ07
anesongezo	REL
esaldanha	NLOC
anabantu	REL
olungasombulula	REL
ezintsokothileyo	REL
okuba	POSS06
zezemali	COP
nawe	ADV
yezicwangciso	POSS04
yimveliso	COP
enjengobuhlwempu	REL
ziphumo	N08
ngenyathelo	ADV
ezingatshintsha	REL
izinga	N05
wokuphendula	POSS03
ngamagcuntswana	ADV
obuvela	REL
ixa	N05
awahlukileyo	REL
zokufunda	POSS08
esivumelekileyo	REL
luphela	REL
yeenguqu	POSS09
isondo	N05
yayindawo	COP
namanqaku	ADV
imanyano	N09
inganomdla	COP
ncipha	V
ekhaya	NLOC
enoxanduva	REL
ngabanxibeleli	COP
uyinene	COP
ngokwesondo	ADV
kwenzame	POSS15
akazwelonke	REL
yemali	POSS09
somzantsi	POSS07
nokuphunyezwa	ADV
thutha	V
ngumongameli	COP
cwangcisa	V
kumaxesha	NLOC
lwezibonelelo	POSS11
lothethwano	POSS05
ubunyani	N14
yongquzulwano	POSS09
benenxaxheba	COP
aqinisekise	REL
nala	ADV
iikopi	N10
esinganelanga	REL
ngokwezigqibo	ADV
ehlayo	REL
kufutshane	ADJLOC
zemikhwa	POSS08
esonelisayo	REL
nemithombo	ADV
enemigangatho	REL
iinkonzo	N10
kukudala	COP
ngomthetho	ADV
nangeenkxalabo	ADV
sogesi	POSS07
awonganyelweyo	REL
okuthembakeleyo	REL
qinisa	V
sekhulu	POSS07
nemida	ADV
nokungaqeshwa	ADV
ezentlalo-luqoqosho	REL
yamali-	POSS09
yabucala	POSS04
abangovimba	REL
anda	V
imbumba	N09
matyotyombe	N06
ye-	POSS09
emazantsi	NLOC
lwenxaxheba	POSS11
leenkcukacha	POSS05
kwangokunjalo	ADV
ngoku	ADV
nokuhamba	ADV
akunaso	COP
yobupolisa	POSS09
nowowiso-mthetho	ADV
okubuthathaka	REL
kwiinqobo	NLOC
olungasebenziyo	REL
sokuvuma	POSS07
zeziphi	COP
kubo	PROEMPLOC
izibonelelo	N08
nothungelwano	ADV
abawafunayo	REL
nangoko	ADV
nekufuneka	ADV
tyala	V
kuphela	ADV
ngokucwangcisekileyo	ADV
fezeka	V
ineajenda	N09
umzabalazo	N03
bokulawula	POSS14
lwenkxaso	POSS11
iba	COP
phazamisa	V
ulwazi	N11
njengabalawuli	ADV
nosuku	ADV
ngcamla	V
ngowokuba	COP
ecace	REL
ummandla	N03
okungaqeshwa	REL
bunako	COP
olusavelayo	REL
kwesizwe	POSS15
banenxaxheba	REL
idayethi	N09
yokuqulunqwa	POSS09
ezibaluleke	REL
neengo	ADV
ongowazo	REL
egunyaziswe	REL
ukungcola	N15
nokugcinakala	ADV
ngamaphepha	COP
amakhonkco	N06
umncedisi	N03
kusenokuba	COP
nezilinganisekayo	ADV
enyakeni	NLOC
tye	IDEO
yonke	PROQUANT09
zeengxelo	POSS10
nako	COP
awayephila	REL
ophezulu	REL
ngokwezinga	ADV
ebicetywe	REL
nekuvunyelwene	ADV
kwezigqeba	POSS15
olulungelelanisiweyo	REL
lwezaziso	POSS11
esincinci	ADJ07
nobudala	ADV
esandayo	REL
lusenokuba	COP
kuwe	ADVLOC
wakutshanje	POSS03
nemibhiyozo	ADV
nohlaziyo	ADV
nemfuno	ADV
akunjalo	COP
uwiso-mthetho	N11
yembono	POSS09
nakuphuhliso	ADV
elikumbindi	REL
kumanzi	NLOC
zicwangciso	N08
ewodwa	PROQUANT03
unemibutho	COP
thabatha	V
ezisebenzise	REL
noququzelela	ADV
xolisa	V
loxanduva	POSS05
unikezelo	N11
ngoxanduva	ADV
ezimxinwa	REL
kungayimfuneko	COP
othintelo	REL
nesicwangciso-qhinga	ADV
ezisebenzisekayo	REL
inomfanekiso	COP
aza	V
yokunqongophala	POSS09
njengomqulu	ADV
nokunobangela	ADV
ezingakhiyo	REL
umahluko	N01a
yonikezelo	POSS09
uthethathethwano	N11
kumaqonga	NLOC
kwezoqoqosho	NLOC
ngokwamaqela	ADV
olungenamkhethe	REL
eyomeleleyo	REL
bomntu	POSS14
ngokubalulekileyo	ADV
akangommi	COP
nesimilo	ADV
zeprojekthi	POSS10
umantyi	N01a
ezinyuliweyo	REL
namhlanje	ADV
yezitsala-manzi	POSS04
eluntwini	NLOC
noxanduva	ADV
wololiwe	POSS03
umda	N03
kwababandakanyekayo	POSS15
ngquzulwano	N11
ebhexeshwayo	REL
yokwenza	POSS04
ukukhanya	N15
esibekwe	REL
wesi-5	POSS03
injani	COP
izigidi	N08
nesahlulo	ADV
iyantlukwano	N09
esiphunyelelwa	REL
zosapho	POSS10
umqobo	N03
lokuzimasa	POSS05
kwincwadi	NLOC
nezifundo	ADV
ngokwesiseko	ADV
lokuqulunqa	POSS05
apha	CDEMLOC
ezibanjiweyo	REL
nokulawula	ADV
zoyedwa	POSS10
undofa	N01a
lwaloo	POSS11
ayidlalayo	REL
specific	FOR
iintsuku	N10
zokubonelela	POSS10
oqinisekisa	REL
ulwaphulo-mthetho	N11
oluthumela	REL
kwamanyathelo	POSS15
kwintando	NLOC
othethwano	POSS06
izifo	N08
kamnu	POSSKA
obona	PROEMP14
awahlukeneyo	REL
ngowama-2001	ADV
ngayo	ADV
ebekwe	REL
icandelo	N05
nezexesha	ADV
iincwadana	N10
ethunyelwayo	REL
ngaba	CONJ
lezemidlalo	POSS05
ufikelelo	N11
nokuzalisekiswa	ADV
kukonke	COP
ishedyuli	N09
yamalungu	POSS04
kwitheyibhile	NLOC
etyhutyha	REL
leendlela	POSS05
okuncedisayo	REL
yemizi	POSS09
kokusebenza	POSS15
ngesicwangciso	ADV
zolwaphulo-mthetho	POSS08
uxolo	N11
kwaphantse	POSS15
umsebenzi	N03
isakhiwo	N07
ngokuqhelekileyo	ADV
zenqanaba	POSS08
3.1	NUM
eyindalo	REL
enkxaso	POSS06
ezinexabiso	REL
lingakanani	COP
othile	REL
yokungqiyama	POSS09
kwezithuba	POSS15
neyedemokhrasi	ADV
yokuvula	POSS09
nentlonipho	ADV
namathela	V
emiswe	REL
wombane	POSS01
ekhuthaza	REL
kwamajelo	POSS15
kwezicwangciso-qhinga	POSS15
esicwangciso	POSS06
nakuhlahlo	ADV
imathiriyeli	N09
enkulukazi	ADJ09
zezona	COP
imigaqo-nkqubo	N04
lokuphucula	POSS05
wezentlalo	POSS03
ngokokuthatha	ADV
oluxhomekeke	REL
esifanayo	REL
ngathi	ADV
iyunivesithi	N09
njengomalathisi	ADV
emitsha	ADJ04
lixhala	COP
uludwe	N11
oluqala	REL
asebenzayo	REL
kwemida	POSS15
ungamhle	COP
obunamandla	REL
yoomasipala	POSS04
axelwa	REL
kwinxenye	NLOC
aphantsi	REL
ngokweemfuno	ADV
zizixeko	COP
zobungcali	POSS10
umz	ABBR
/	PUNC
ibala	N05
amkela	V
ngoqwalaselo	ADV
olukhuselekileyo	REL
kwaba-6	NLOC
lwekhomishoni	POSS11
ezihlanu	ADJ08
engamanzanga	REL
wentlanganiso	POSS03
zikhalazo	N08
kwiingxelo	NLOC
lemfundo	POSS05
yelungu	POSS04
karhulumente	POSSKA
lomthathi-nxaxheba	POSS11
asondele	REL
kuzo	PROEMPLOC
yintshayelelo	COP
uqulunqo	N11
ngokufikelelwa	ADV
ezine	ADJ10
ngokwasekuhlaleni	ADV
emgangathweni	NLOC
yeqondo	POSS09
somjikelo	POSS07
yokulungelelanisa	POSS09
abasayi	VAUX
asingabo	COP
wonke	PROQUANT01
nokwenza	ADV
iicawa	N10
sokunganxibelelani	POSS07
yemimiselo	POSS09
uqukuqelo	N11
lwenguqu	POSS11
kwizakhiwo	NLOC
kukatitshala	POSS15
ngesondo	ADV
ezinikwayo	REL
njengosapho	ADV
nabeshishini	ADV
iyadi	N09
kwecuba	POSS15
oluchanekileyo	REL
kwisimo	NLOC
lokulamla	POSS11
nemali	ADV
ezinjenge-overhead	REL
oluchithayo	REL
edla	REL
bezithuthi	POSS02
njengelungu	ADV
nokohluka	ADV
okukhulu	ADJ15
nokukhusela	ADV
ombono	POSS06
engunombolo	REL
nemithetho	ADV
oonomakhaya	N02a
lunamagosa	COP
abasebenzisana	REL
neyimiba	ADV
adinga	REL
nezempilo	ADV
ngokwezintlu	ADV
enempumelelo	REL
nolihlwempu	ADV
zokusiwa	POSS08
nokunyinwa	ADV
wina	V
kwezakhono	POSS15
nesiqhamo	ADV
okugqwesa	REL
kumanye	ADJLOC
amabango	N06
neenkcukacha	ADV
mpefu	NPP
umelo	N11
njengenzuzo	ADV
lwezakhono	POSS11
iimpawu	N10
kwesininzi	POSS15
kwinkqubela-phambili	NLOC
bangaphandle	POSS02
avumelana	REL
no-b	ADV
khuthaza	V
abangekho	REL
elenza	REL
neziphakamiso	ADV
yokulwa	POSS09
yeengcinga	POSS09
wedigri	POSS03
iirhafu	N10
esineenkcukacha	REL
elinokunikezela	REL
iingozi	N10
yiba	COP
nababhexeshi	ADV
ngaphambili	ADV
yentlalo	POSS09
ngokwenzeka	ADV
senzuzo	POSS07
abayithathayo	REL
ngabasebenzi	ADV
kubambiswano	NLOC
loluntu	POSS05
neengxaki	ADV
yengxelo	POSS09
namacwecwe	ADV
nokunikwa	ADV
zempilo	POSS10
zoshishino	POSS10
iqondo	N05
icebiso	N05
zesini	POSS10
okuzala	POSS06
ithuba	N05
neentsukaphi	ADV
umeya	N01a
elikhokelwa	REL
nomntu	ADV
neyamaphondo	ADV
abancedayo	REL
2.2	NUM
nangenyaniso	ADV
ingabinakhethe	COP
esiphambili	REL
leempiliso	POSS05
nabangasaphiliyo	ADV
nokungaphathwa	ADV
ngaxesha	ADV
eseka	REL
nezezimali	ADV
lama-75	POSS05
hlwila	V
mfutshane	COP
kwimimandla	NLOC
abanzi	REL
esingaguquguqukiyo	REL
wobuchwepheshe	POSS06
eyintloko	REL
ezigaba	REL
namanzi	ADV
yintoni	COP
wocalulo	POSS03
leprojekthi	POSS05
yeedolophu	POSS04
zizakhelo	COP
ezifanelekileyo	REL
ezingazinzanga	REL
eminye	ADJ04
enkonzo	POSS06
eningqongileyo	REL
nophuhlisayo	ADV
koorhulumente	NLOC
nolupheleleyo	ADV
ezilindelekileyo	REL
izikhokelo	N08
kulungiso	NLOC
nakwiimeko	ADV
abathunywa	N02
imiqathango	N04
oluqulathwe	REL
kakuhle	ADV
phelela	V
kwizidingo	NLOC
ngesifundwana	ADV
elincinane	ADJ05
ebezishiyelelwe	REL
ngokuzenzekelayo	ADV
kungasentla	COP
kutshintsho	NLOC
lokubamba	POSS05
sokususa	POSS07
nagxeke	COP
ngesikukhethayo	ADV
amancinci	ADJ06
ithenda	N09
umqondiso	N03
enjani	REL
phandle	ADV
nobulunga	ADV
zamaxesha	POSS10
b	ABBR
ngendlu	ADV
lobunini	POSS11
nemidla	ADV
ubuntu	N14
babantu	POSS14
yokwandlaleka	POSS09
aziingcali	REL
okukhoyo	REL
onokusetyenziswa	REL
sikarhulumente	POSS07
ongumongikazi	REL
naluphina	ADV
ne-idp	ADV
weshishini	POSS03
sobume	POSS07
ngokoke	ADV
nonophela	V
lweqela	POSS11
nqanda	V
seenqwelo-moya	POSS07
layita	V
ngokophuhliso	ADV
kwilizwe	NLOC
elifutshane	ADJ05
nangezicwangciso-buqili	ADV
lesitishi	POSS05
ziinjongo	COP
weprojekthi	POSS03
yokuveliswa	POSS09
zezithuba	POSS10
equkiwe	REL
bolawulo	POSS14
lunga	V
kwentlanganiso	POSS15
nawomnqweno	ADV
kokufundela	POSS15
oluxhaswayo	REL
okuneziphumo	REL
anenzuzo	REL
ineempembelelo	COP
olwandle	POSS06
yokuphawula	POSS09
wawumalunga	ADV
kaninzi	ADV
nee-1960	ADV
nokubuyiswa	ADV
inkcazo	N09
m	NPP
wolwazi	POSS01
sezindlu	POSS07
ama-40	N06
olubandakanyayo	REL
kuwiso-mthetho	NLOC
okuyintloko	REL
njengenxalenye	ADV
nomsindo	ADV
kube	COP
lunenjongo	COP
kuhlobo	NLOC
bazo	POSS14
labasebenzi	POSS05
esisetyenziswa	REL
ngabathabathi-nxaxheba	ADV
oyenzayo	REL
olucokisiweyo	REL
olunamandla	REL
korhulumente	POSS15
kwiingxoxo-mpikiswano	NLOC
iimeko	N10
banekopi	COP
nezindlu	ADV
ezijikayo	REL
elinikwe	REL
kokuthile	POSS15
okunegalelo	REL
tyekela	V
ezilunikezelayo	REL
yi-logical	COP
micimbi	N04
kwabahlali	POSS15
indlu	N09
lophando	POSS05
kumele	VAUX
izitendi	N08
sisithethi	COP
okubumba	REL
nciphisa	V
ezibonelelo	POSS06
bay	NPP
ababandakanyeka	REL
sengingqi	POSS07
abanempembelelo	REL
azo	POSS06
nasezifama	ADV
impumelelo	N09
ezaziphawulwe	REL
bomvuzo	POSS14
njengongenampumelelo	ADV
olahlekelwa	REL
wemigodi	POSS03
engumngeni	REL
anesivumelwano	REL
nombono	ADV
kwisikhokelo	NLOC
azenzileyo	REL
uvukelo-mbuso	N11
e-pr	POSS06
beendawo	POSS02
esinika	REL
195	NUM
nakwiindleko	ADV
ngokubonakalyo	ADV
ezikhuselwa	REL
lwezicwangciso	POSS11
zomhlaba	POSS10
nokuphuhliswa	ADV
nolwezibonelelo	ADV
neenjongo	ADV
abanyulwa	N02
abanokufikelela	REL
ngezi	ADV
banga	V
zesigaba	POSS10
yokufunda	POSS09
achaphazelekayo	REL
eepropati	POSS06
nange-logframe	ADV
nesitishi	ADV
ngokomeleza	ADV
kunzima	COP
zobugcisa	POSS08
gca	IDEO
usibonda	N01a
ezisemgangathweni	REL
umbuzo	N03
olulodwa	REL
esipheleleyo	REL
yekhomishoni	POSS09
lulawulo	COP
zimpendulo	N10
vuza	V
kwakusisisombululo	COP
ahlanganisiweyo	REL
nawomgaqo-siseko	ADV
ugutyulo	N11
esithi	REL
lekomiti	POSS05
zothethwathethwano	POSS08
152	NUM
nokuphathwa	ADV
yeqonga	POSS04
ekuqhutywa	REL
imidla	N04
kwekhabhoni	POSS15
mpompo	N09
okubuyisela	POSS03
nokunyanzelisa	ADV
ngengxoxo	ADV
neenkokheli	ADV
zezinye	COP
yophuhliso	POSS04
omalunga	REL
namaqalela	ADV
74a	NUM
nelomeleza	ADV
nangokuncomekayo	ADV
cukula	V
kwisibini	ADJLOC
bungekho	COP
esemaphandleni	NLOC
somthi	POSS07
iinguquko	N10
wolandelelwano	POSS03
khuphisana	V
ezinjalo	REL
nobelizwe	ADV
wophuhliso	POSS03
nokubona	ADV
wamalungu	POSS06
ecac	ABBR
efanayo	REL
zokwenziwa	POSS10
elinako	REL
ngomngxuma	ADV
alandele	REL
kwiiyunithi	NLOC
ebomini	NLOC
ndlela	N09
ahlangabezana	REL
nawamaphondo	ADV
omabini	PROQUANT06
ezinkulu	ADJ10
ngokukhethekileyo	ADV
umdlalo-linganiso	N03
yangowama-2009	POSS09
umyeni	N01
ayiyo	COP
enamathelayo	REL
ngokungajikajikiyo	ADV
yimpendulo	COP
ngenkathalo	ADV
enempilo	REL
nenqanam	ADV
lokujonga	POSS05
lungelo	ADV
kwengasemva	NLOC
ezi-2	REL
ngokuthembekileyo	ADV
okuya	REL
ugqaliselo	N11
kekela	V
iimpepha	N10
intetho	N09
wetyala	POSS03
namahlakani	ADV
ephuculiweyo	REL
zalana	V
zokususa	POSS10
zikazwelonke	POSS10
iimvavanyo-zimvo	N10
lengxelo	POSS05
nobugebenga	ADV
neforam	ADV
kophuhliso	POSS15
azisayi	VAUX
esinxibelelana	REL
ootitshala	N02a
nezixabisekileyo	ADV
lolawulo	POSS05
yembalela	POSS09
baphesheya	ADV
kwelinye	POSS15
okuququzelela	REL
bowama-2000	POSS14
nyaka	N03
ezandisiweyo	REL
ingezizo	COP
oluphambili	REL
olunemphumelelo	REL
ncoma	V
kwishedyuli	NLOC
okungcono	REL
lwesixokelelwano	POSS11
umhlalaphantsi	N03
ezobugcisa	REL
cacisa	V
nolwenziwa	ADV
ekhawuleza	REL
umnikezeli	N01
yezifezekiso	POSS04
ngokweenkalo	ADV
impahla	N09
neendawo	ADV
buyimfuneko	COP
mibandela	N04
ilizwekazi	N05
ongalinganiyo	REL
zokusebenzisa	POSS08
enegalelo	REL
abangaqeshwanga	REL
ngokugqithise	ADV
ewonke	COP
engaguquguqukiyo	REL
noluhlu	ADV
ngabavoti	ADV
sokuqokelela	POSS07
ngowama-2020	ADV
obusetyenzisiweyo	REL
nobuqabane	ADV
wesifo	POSS03
ngelinye	ADV
ezi	CDEM10
ende	ADJ09
yakutsha	POSS04
39	NUM
bendawo	POSS02
ikwangamaxhala	COP
kwimizi-mveliso	NLOC
nokumiliselwa	ADV
sikweni	NLOC
thumela	V
decision-makers	FOR
noluza	ADV
ngokuphumeza	ADV
eziluncedo	REL
esikhokelela	REL
lwenu	POSS11
yesigaba	POSS09
kweenyanga	POSS15
khawulela	V
lwezikhundla	POSS11
obubonakalayo	REL
eziziingcinga	REL
ngemibandela	ADV
kwesithuba	POSS15
kwezolimo	NLOC
bawo	POSS02
elandayo	REL
nesizathu	ADV
ezisesitalatweni	REL
transition	FOR
nokugcinwa	ADV
linqanaba	COP
aziyi	VAUX
modeli	N00
ngokusebenzayo	ADV
kuhlalutyo	NLOC
bamaqela	POSS02
losapho	POSS05
kumagunya	NLOC
nasekugungqiseni	ADV
yolwakhiwo-zindlu	POSS09
ziingcali	COP
iipasele	N10
abazalise	REL
nenkuthazo	ADV
baphantsi	COP
lwezigqibo	POSS11
nokuhloniphana	ADV
ezijoliswe	REL
kumapolisa	NLOC
njengokuguquka	ADV
zeethagethi	POSS10
injineli	N09
wama-64	POSS03
ulungelelaniso	N11
sakuqala	POSS07
eziyimpumelelo	REL
kukwiintlanganiso	COP
nobomi	ADV
mava	N06
ezisilelayo	REL
esetyenziswa	REL
ndawonye	ADJ09
lwesikhokelo	POSS11
kusebenziswano	NLOC
ezisasazwe	REL
ngobulungisa	ADV
nangenkuthalo	ADV
okwenzekileyo	REL
abakhethiweyo	REL
malinge	N06
nenkqubela-phambili	ADV
ngamalungiselelo	ADV
zivumelwano	N08
esizimeleyo	REL
athungelanayo	REL
lokukhangela	POSS11
nesebenza	ADV
i-67%	N09
yesondlo	POSS09
kungakho	COP
yamanzi	POSS09
likamasipala	POSS05
omandla	REL
yoluntu	POSS09
zabantu	POSS10
omelela	V
njalo-njalo	ADV
edlulileyo	REL
nendawo	ADV
okokuqala	ADV
ezifumanekayo	REL
abatshutshisi	POSS06
sokulingwa	POSS07
zama	V
-abahlali	N02
isidibi	N07
nasekuphandeni	ADV
yesikolo	POSS09
womhla	POSS03
laze	VAUX
yokubheka	POSS09
olukhulu	ADJ11
baso	POSS14
iinkcazelo	N10
ezokukhangela	REL
izakhono	N08
kweliso	POSS15
ovuselelayo	REL
ngokunyusa	ADV
neekomiti	ADV
basezikhundleni	COP
nonikezelo	ADV
ubuninzi	ADJ14
wobomi	POSS03
obandayo	REL
akhulelweyo	REL
ahlula	V
yephondo	POSS09
ngobuninzi	ADV
zokuba	POSS08
wezemidlalo	POSS03
babemi	POSS14
ngumthundezi	COP
va	V
noluntu	ADV
yexeshana	POSS04
olwamadoda	REL
iimvula	N10
yezakhono	POSS09
khula	V
khonza	V
nekwamele	ADV
zokunikezela	POSS10
management	FOR
enyanisweni	NLOC
zokuqalisa	POSS10
notyalo-mali	ADV
ogcino-cwangco	POSS06
nengxelo	ADV
bengxaki	POSS14
ezinokuvela	REL
lolungiselelo	POSS05
ze-aids	POSS10
ii-cdw	N10
kwaphezulu	ADV
achasene	REL
nolunesiphiwo	ADV
ngamandla	ADV
ebusuku	NLOC
nobungcaphephe	ADV
ngokuqokelela	ADV
kabini	ADV
ngeengcebiso	ADV
yamaqela	POSS09
uhlobo	N11
lwabiwo-mali	N11
ekugxilwe	REL
nezikhundla	ADV
kubahlali	NLOC
cycle	FOR
sezizathu	POSS07
bethelela	V
lawula	V
kwiziqhamo	NLOC
ezibambekayo	REL
xhaphaza	V
lobunkokheli	POSS11
elishumi	REL
olungabantu	REL
kwizigaba	NLOC
okwahlukeneyo	REL
kuyiyo	PROEMP09
esigqityezelwayo	REL
ababhalisiweyo	REL
okungundoqo	REL
umlambo	N03
elandelayo	REL
nasekusetyenzisweni	ADV
esibaluleke	REL
nokunqongophala	ADV
nokuzinikela	ADV
lorhwaphilizo	POSS11
ezisekiweyo	REL
esakhayo	REL
engagudanga	REL
yeziphathamandla	POSS09
kweshishini	POSS15
kwelizwe	POSS15
benezakhono	COP
weekomiti	POSS03
maxhala	N06
efihliweyo	REL
iza	VAUX
nezabasebenzi	ADV
umbhexeshi	N01
ngxaki	N09
neyokuziphumeza	ADV
ufundo-nzulu	N11
linayo	COP
kungekuhlanga	COP
yanikwa	POSS09
nokuthile	ADV
ezihluphekileyo	REL
nasekunciphiseni	ADV
kwekhontraka	POSS15
nepms	ADV
ashiyekileyo	REL
inxaxheba	N09
afanayo	REL
ekunikezelwa	REL
ungabimhle	COP
eseleyo	REL
liselihle	ADJ05
kweentloko	POSS15
nokuphuhlisa	ADV
umxhasi	N01
elingelinye	REL
wokusombulula	POSS03
alimeleyo	REL
loorhulumente	POSS11
isemthethweni	COP
yemveliso	POSS09
ngokuphathelele	ADV
nokujongwa	ADV
ebachaphazela	REL
lesithethe	POSS05
udano	N11
unyamezelwano	N11
kuwonke-wonke	ADVLOC
eyimivuka	REL
phucula	V
lweengingqi	POSS11
nokusilela	ADV
dlela	V
sokubeka	POSS07
emaphandleni	NLOC
25(1)	NUM
kukhuselo	NLOC
nolwahlukenenyo	ADV
zengqondo	POSS10
kwewadi	POSS15
namalungelo	ADV
1969	NUM
e	ABBR
anokunceda	REL
nolwamkelo	ADV
zoba	V
nakwizisombululo	ADV
emalunga	REL
nambitha	V
kubaphathi	NLOC
nokunciphisa	ADV
banabathunywa	COP
zabahlali	POSS08
ngeziphumo	ADV
ezidla	REL
wokuzalisa	POSS03
neeforam	ADV
lwabachaphazelekayo	POSS11
nomahlulelane	ADV
sokuqinisekisa	POSS07
nesishwankathelo	ADV
kwesikolo	POSS15
iimpendulo	N10
eziphezulu	REL
ngokuqinisekisa	ADV
i-gep	N09
elingakanani	REL
udidi	N11
se-batho	POSS07
ngaphezu	ADV
lungenayo	COP
ahluka-hlukileyo	REL
ngezobugcisa	ADV
ombi	ADJ03
ineeseti	COP
eliziko	REL
inkokheli	N09
ne-logframe	ADV
i-municipal	N09
uza	VAUX
nokhathalelo	ADV
uliphupha	COP
elidibanisa	REL
ukunakana	N15
ibhokisi	N09
ikwangumsombululi	COP
ezibaxekileyo	REL
abameli	N02
neecbo	ADV
ezinyanzelisiweyo	REL
somntu	POSS07
equlethwe	REL
i-division	N09
ngokungcono	ADV
se-logframe	POSS07
abaninzi	ADJ02
ngokuthembakeleyo	ADV
tyhila	V
nelizimelayo	ADV
somthonyama	POSS07
i-kpi	N09
efunyaniswa	REL
awulolandelelwano	COP
asingelwa	REL
eliqhutywayo	REL
olwakho	REL
kobulunga	POSS15
ugunyaziso	N11
phulukana	V
nobambiswano	ADV
ngokufutshane	ADV
zokunikezelwa	POSS08
njl	ABBR
encitshisiweyo	REL
liluxwebhu	COP
uneekopi	COP
ophuhliswe	REL
itshathi	N09
yelizwi	POSS09
neyawo	ADV
esweni	NLOC
meko	N00
kwe-idp	POSS15
engena	REL
ejongene	REL
aphuhlileyo	REL
njengelungelo	ADV
ahlelelekileyo	REL
bezinto	POSS14
wer&d	POSS03
engama-20	REL
zepalamente	POSS08
kwibhunga	NLOC
i-batho	N09
i-ofisi	N09
nokuqiniswa	ADV
thandabuza	V
dwela	V
mfuneko	N09
ceba	V
bopolitiko	POSS14
yeekomiti	POSS09
ubugebenga	N14
lokuhlala	POSS05
zizonke	COP
joyina	V
ngokwentando	ADV
esibangele	REL
zezi	POSS08
yasemthethweni	POSS09
lwezesondo	POSS11
nesiseko	ADV
phambi	ADV
boluntu	POSS14
egameni	NLOC
msebenzi	N01
kwelama-67	NLOC
andlala	V
singezantsi	REL
konyaka	POSS15
kwabanye	POSS15
kobomi	POSS15
athiwe	REL
ngokucacisa	ADV
nabanyulwe	ADV
zomgaqo-siseko	POSS10
nenefuthe	ADV
oomama	N02a
ehambisa	REL
nezikrokro	ADV
ngapha	ADV
anjengeforam	REL
kwekamva	POSS15
sabemi	POSS07
lwesicwangciso-nkqubo	POSS11
kwiimfuneko	NLOC
engqongileyo	REL
ekusetyenzwa	REL
kumbutho	NLOC
ukwisicwangciso	COP
kubathathi-nxaxheba	NLOC
ngovelwano	ADV
kweziphi	ADJLOC
ebuhlwempini	NLOC
ngokukhawulezileyo	ADV
nokucwangciswa	ADV
kwezi	CDEMLOC
kwanokwandisa	ADV
zesiganeko	POSS08
june	FOR
yozalisekiso	POSS09
nakumalungu	ADV
abohlukeneyo	REL
ofanelekileyo	REL
olugcweleyo	REL
agqithisileyo	REL
amaxwebhu	N06
noxilongo	ADV
amanyanise	REL
zamazwe	POSS10
unomathotholo	N01a
edurban-gauteng	NLOC
ephezulu	REL
esakhulayo	REL
nezicwangciso-buqili	ADV
zezigqibo	POSS10
nokuyila	ADV
okungalinganiyo	REL
kwizowuni	NLOC
asebenza	REL
kokwenziwa	POSS15
bubuso	COP
yomjikelo	POSS09
ngokuthe	ADV
abangaqhagamshelana	REL
nowenza	ADV
noqeqesho	ADV
lwesixhobo	POSS11
kushishino	NLOC
kwezesicwangciso-qhinga	NLOC
nokuqal'ugwebe	ADV
isivuno	N07
isincedisi	N07
nokuqhuba	ADV
beshifu	POSS02
ngokuhlalutya	ADV
ibengumthwalo	COP
umjikelezo	N03
wexesha	POSS03
sababhexeshi	POSS07
kuthungelwano	NLOC
ahluka	V
ezinobungozi	REL
okhululekileyo	REL
bopha	V
singela	V
mbandela	N03
kunye	CONJ
yabanini	POSS04
nowokukhangela	ADV
kwamanxeba	POSS15
nokwananiselana	ADV
amadoda	N06
zimbo	N08
ehambelanayo	REL
sewadi	POSS07
800mw	ABBR
yokuphelisa	POSS09
echithwe	REL
yangumyinge	COP
kwiindleko	NLOC
zikamasipala	POSS10
7.00	NUM
neemvula	ADV
kwiithagethi	NLOC
nawuphina	ADV
lweengxelo	POSS11
namacebiso	ADV
eqhuba	REL
nokuthelekiswa	ADV
athenjiweyo	REL
sicwangciso	N07
kwiinzuzo	NLOC
ubume	N14
okusingqongileyo	REL
nkxaso	N09
sokuzigwebela	POSS07
abanentlonelo	REL
elinyuliweyo	REL
nabani	INTER
oya	REL
kwiintlobo	NLOC
ngentla	ADV
ekunye	COP
yila	V
olukhuphisanayo	REL
nokufikeleleka	ADV
nophuculo	ADV
neenkundla	ADV
okuphucula	REL
inguqulelo	N09
tshitsha	V
zangaphandle	POSS10
osezantsi	REL
kukusingasinga	COP
bezimbiwa	POSS14
zokupaka	POSS10
equka	REL
intshayelelo	N09
nangumgangatho	ADV
neefom	ADV
ukungabinamagingxigingxi	COP
kubathathi-nxheba	NLOC
bamashishini	POSS02
ithemba	N05
lweenkqubo	POSS11
nakwizindlu	ADV
zengqesho	POSS10
yokuseka	POSS09
zokwabelana	POSS08
suka	V
olulungileyo	REL
iindibano	N09
elingasebenzisa	REL
imanejala	N09
onokuthanda	REL
kungabi	COP
abafumene	REL
umzamo	N03
yokusebenzisa	POSS09
chitha	V
yokwahlula	POSS09
ku-3.2.5	NLOC
zamandla	POSS10
onolwazi	REL
mizekelo	N04
esiyinzuzo	REL
zepotfoliyo	POSS10
ngokukhokelela	ADV
imilinganiselo	N04
ze-pms	POSS10
ilelo	COP
olulungiswe	REL
kunotyalo-mali	ADV
cbo	ABBR
babo	POSS02
kwamarhe	POSS15
yabalandeli	POSS09
izivumelwano	N08
esisodwa	REL
okufutshane	ADJ15
eziyilelwe	REL
nawuphi	ADV
elipheleleyo	REL
nongumsebenzi	ADV
yeempahla	POSS09
thaca	IDEO
inoceba	COP
nokuqoshelisa	ADV
ngokuphindwe	ADV
yezibonelelo	POSS09
ubumi	N14
yobuninzi	POSS09
kwimpumezo	NLOC
zidlulileyo	REL
akwanexhala	COP
anexabiso	REL
inzaliso-mali	N09
yamalungiselelo	POSS04
nelithe	ADV
ngokunyanisekileyo	ADV
nokujoliswe	ADV
ayisayi	VAUX
yokwalatha	POSS04
-	PUNC
ngokuphelela	ADV
iyure	N09
ngokwezelizwe	ADV
kumbono	NLOC
kumasango	NLOC
bemithombo	POSS14
bakarhulumente	POSS02
iimposiso	N10
qhambuka	V
kwaye	CONJ
eseyenziwe	REL
xabiso	N05
nokufumana	ADV
alandelayo	REL
iindima	N10
company	FOR
ngelizwi	ADV
wobutshaphatshapha	POSS03
ingabula-zigcawu	N09
eziphicothiweyo	REL
lemisebenzi	POSS05
lini	ADJ05
zingabi	COP
yekhabhinethi	POSS09
elenziwe	REL
lwamaqonga	POSS11
uba	COP
emazibekwe	REL
senqwelo-moya	POSS07
ebachaphazelayo	REL
azinikezelayo	REL
elibanzi	REL
lesini	POSS05
yokulungisa	POSS09
elolo	REL
anengeniso	REL
novelwano	ADV
oluphakamisa	REL
nocebawewadi	ADV
ngokuququzelela	ADV
ku-1970	NLOC
amaxhala	N06
baneminyaka	REL
isicwangciso	N07
ngokubuyekeza	ADV
sisindululo	COP
omkhulu	ADJ03
ophakathi	REL
ngobuchule	ADV
yangoku	POSS09
othethayo	REL
emanzi	REL
nqaba	V
yethuba	POSS04
izifundo	N08
lilonke	COP
nabahlali	ADV
ekholisa	REL
abakhethwe	REL
nakanjalo	ADV
tshutshisa	V
yokuhlawula	POSS09
beya	VAUX
i-eastern	N09
kwinqanam	NLOC
kweli	CDEMLOC
okuchongileyo	REL
yobuchwepheshe	POSS09
eziphantsi	REL
yeyunivesithi	POSS09
nakwiphondo	ADV
imigaqo	N04
nokucwangcisa	ADV
ziziphathamandla	COP
abangabavoti	REL
solunye	POSS07
sesinye	COP
izidingo	N08
yamanyathelo	POSS09
gazette	FOR
nasekubekweni	ADV
yokuvelisa	POSS09
nejaji	ADV
nelizwi	ADV
isebe	N05
kwiinkonzo	NLOC
eziyibangayo	REL
onokukunceda	REL
phucuka	V
amafama	N06
zasemaphandleni	POSS10
yiphi	COP
ngokuqaqambisa	ADV
smith	NPP
ngowama-24	ADV
ezitratweni	REL
ezizemidla	REL
ngezinto	ADV
ngokulula	ADV
lengxaki	POSS05
ikhontrakthi	N09
nococeko	ADV
ngumamkeli	COP
ecacileyo	REL
ezintlanganisweni	NLOC
kobungcali	POSS15
nokunyanisekiswa	ADV
kwidrafti	NLOC
nalungisayo	ADV
kwemozulu	POSS15
ezikhokelela	REL
maqela	N06
kweemfuno	POSS15
kwisabelo	NLOC
zentlanganiso	POSS08
ezingama-20	REL
ezinokuqhutywa	REL
imitha	N04
abasebancinci	ADJ02
ikhoyo	COP
neklinikhi	ADV
olungacwangciselwanga	REL
nasekufikeleleni	ADV
owakhe	REL
kwii-ngo	NLOC
isiswangciso	N07
tshixa	V
neentlobo	ADV
kwizimvo	NLOC
esiphendula	REL
yamaqalela	POSS09
kwasekuhlaleni	POSS15
nemisebenzi	ADV
lweeyantlukwano	POSS11
yezolimo	POSS04
ngokuveliswa	ADV
baya	VAUX
zisenokuba	COP
lona	PROEMP11
zimela	V
nokubhexesha	ADV
amawaka	N06
framework	FOR
zigqeba	N08
kwenkonzo	POSS15
wamaphondo	POSS01
sihloko	N07
enokufuna	REL
eyidlalile	REL
esokuqala	REL
kweenkqubo	POSS15
kpi	ABBR
ezivelileyo	REL
nokucenga	ADV
lwabamnyama	POSS11
lisisakhelo	COP
onokujongana	REL
eziliqela	REL
bakwaziyo	REL
lobutyebi	POSS05
irhafu	N09
kokukhula	POSS15
wedolophu	POSS01
zeemfuno	POSS08
kwifliptshathi	NLOC
xinezelelo	N00
sokusebenza	POSS07
ezenziweyo	REL
olunobulunga	REL
nangenza	ADV
okugcinakalayo	REL
nasekukhuseleni	ADV
lombuso	POSS05
nabadala	ADV
kwizigqibo	NLOC
negalelo	ADV
yokubhala	POSS09
eligcinakalayo	REL
kopolitiko	POSS15
yoxolelwaniso	POSS09
wokoluka	POSS03
nokuphuculwa	ADV
yi-cbp	COP
imanganisi	N09
iveki	N09
aliqela	REL
nqaku	N09
owamkelekileyo	REL
ngokulima	ADV
ezingaphaya	REL
inqaku	N05
ngemicimbi	ADV
uthotho	N11
ngababini	COP
i-idp	N09
zabathengisi	POSS08
benkxaso	POSS14
komntu	POSS15
esingavumelekanga	REL
fika	V
yasetshwane	POSS09
buqu	N14
sokubandakanya	POSS07
ngoomasipala	ADV
gcwalisa	V
zezifo	POSS08
abaphantsi	REL
ngokwembali	ADV
vuma	V
ecwangcisayo	REL
kuwadi	NLOC
amarhe	N06
imifuziselo	N04
hayi	INT
ngesithili	ADV
kwisixeko	NLOC
beprojekthi	POSS02
jikeleza	V
kwasekhaya	POSS15
nasezitalatweni	ADV
lokuqala	POSS05
kwisimilo	NLOC
nokwamkelwa	ADV
oqhuba	REL
namagosa	ADV
kwiinkqubo	NLOC
yembali	POSS04
sela	V
kungenxa	COP
besicwangciso-nkqubo	POSS14
izityalo	N08
lonyulo	POSS05
imbali	N09
kumjikelo	NLOC
nokutotoba	ADV
neemakha	ADV
kwamanani	POSS15
kuzalisekiso	NLOC
imilo	N09
njengabanoxanduva	ADV
ngokwabagunyaziswa	ADV
kwiajenda	NLOC
samasebe	POSS07
enye	ADJ09
sisikhokelo	COP
soqeqesho	POSS07
okuveza	REL
kwintlanganiso	NLOC
le-idp	POSS05
mithetho-siseko	N04
eqikelelweyo	REL
yabahlawuli	POSS04
olungeluhlanga	REL
enzuzo	POSS06
ngenene	ADV
obunokuthi	REL
olunge	REL
sisiseko	COP
kwi-east	NLOC
zorhwebo	POSS10
injongo	N09
abangaphangeliyo	REL
imivuzo	N04
lolwazi	POSS05
iitheyibhile	N10
nendima	ADV
ngokufanelekileyo	ADV
olubavumela	REL
imimiselo	N04
lwesicwangciso	POSS11
kukazwelonke	POSS15
nokulinganisela	ADV
qonga	N05
eenkqubo	POSS06
lwamasebe	POSS11
nobunye	ADV
nokhuselo	ADV
i-intergovernmental	N09
nakwizicwangciso	ADV
abasenokuba	REL
esivelisa	REL
inohlahlo	COP
nzala	N09
kungangabikho	COP
ngokusekwe	ADV
kwingingqi	NLOC
unako	COP
nokuvavanywa	ADV
ezixabisekileyo	REL
seidp	POSS07
nommeli	ADV
engenye	REL
kwiikomiti	NLOC
nokuyichaphazela	ADV
bubudala	COP
yobungcali	POSS04
ngeengxowa-mali	ADV
nezokunikezela	ADV
lomhlaba	POSS11
fikelela	V
wendlela	POSS03
nokuthandabuza	ADV
tshaya	V
ngokutyelela	ADV
kuya	VAUX
lwabahambi	POSS11
ngoququzelelo	ADV
inyikityha	N09
kulumano-ndlebe	NLOC
olunokungxala	REL
obuphakathi	REL
yokunikezela	POSS09
nee-cbo	ADV
esiya	REL
ngemfuneko	ADV
kweshishi	POSS15
ii-swot	N10
obudala	POSS06
kwezigqibo	POSS15
eziphathelele	REL
kwenjongo	POSS15
ze-mfma	POSS10
nasekomelezeni	ADV
ecela	REL
lolungiso	POSS05
ohlalutyo	POSS06
yasemzimbeni	POSS09
namaqela	ADV
lwakho	POSS11
oluqhubekayo	REL
ezifana	REL
uthutho	N11
amagosa	N06
nokuqhubekeka	ADV
umbeki	N01a
lama-65	POSS05
ubuso	N14
kuluhlu	NLOC
yorhwaphilizo	POSS04
zii-exco	COP
yena	PROEMP01
njengesiza	ADV
kokubaluleka	POSS15
kwifuthe	NLOC
zombini	PROQUANT10
nemiyalelo	ADV
nabexesha	ADV
kwindlela	NLOC
ekuthethwa	REL
ekubhalwe	REL
enyanisekileyo	REL
nokuphawulwa	ADV
uqobo	N11
ngokuxhaswa	ADV
kwizikhundla	NLOC
akukuba	COP
ezikuluntu	REL
nangeziphi	ADV
amalungiselelo	N06
ngokuchonga	ADV
mithombo	N04
sesamagosa	COP
esixekweni	NLOC
lecandelo	POSS05
lelizwe	POSS05
000mw	ABBR
'	PUNC
hlahlela	V
ngokwamalungelo	ADV
kuduru	COP
oluphezulu	REL
be-idp	POSS02
abalinikayo	REL
kwe-cbp	POSS15
zemizi-mveliso	POSS10
yamanyama	POSS09
maxabiso	N06
kumalunga	COP
kugcino	NLOC
we-0.5	POSS03
echaza	REL
amakhulukazi	ADJ06
obusekelwe	REL
goduka	V
yobumeli	POSS09
okukhawulezileyo	REL
namakhwenkwe	ADV
akumazantsi	REL
kwiprojekthi	NLOC
olungxabalaza	REL
kumakhaya	NLOC
olwaphulo-mthetho	POSS06
yeefestival	POSS04
kupolitiko	NLOC
kwenkqubo	POSS15
nakunxweme	ADV
ibhodi	N09
zonxibelelwano	POSS10
elawulwa	REL
amashishini	N06
umgangatho	N03
nezindululo	ADV
elichongiweyo	REL
kunobundlongondlongo	COP
axhalabisayo	REL
nokumema	ADV
ikufutshane	COP
zeengxowa-mali	POSS08
lesixeko	POSS05
yokugqitywa	POSS04
sangaphambili	POSS07
okungakumbi	REL
yesixa-mali	POSS09
yintsukaphi	COP
yepalamente	POSS09
zeenkqubo	POSS10
vumela	V
lengingqi	POSS05
kwamaphulo	POSS15
somntwana	POSS07
engumahluko	REL
kunxulumano	NLOC
lonxibelelwano	POSS11
we-10	POSS03
nezenziwe	ADV
yokugcina	POSS04
ezivelayo	REL
esirhweba	REL
esomalia	NLOC
imandla	REL
ziganeko	N08
esetyenziswe	REL
noshishino	ADV
kokulawula	POSS15
emihlanu	ADJ04
equlunqwe	REL
phicotha	V
olukumgangatho	REL
kurhwaphilizo	NLOC
obungaphandle	REL
athathwa	REL
abajamelana	REL
banomsindo	COP
endleleni	NLOC
evela	REL
kungquzulwano	NLOC
dimbaza	V
kwezoshishino	NLOC
angakhethi	REL
ngentsimbi	ADV
wesikhokelo	POSS03
sokuqulunqa	POSS07
mnye	ADJ03
eliyibhakana	REL
grumba	V
kwezikhundla	POSS15
kwigqugula	NLOC
kwabantu	POSS15
nequka	ADV
wamabhinqa	POSS03
nogqithiso	ADV
unxibelelwano	N11
ube	COP
imimandla	N04
nzaliso-mali	N09
rhoqo	IDEO
omeleza	V
olusebenzisanayo	REL
impatho	N09
nongquzulwano	ADV
lokukhwela	POSS05
kucalucalulo	NLOC
nasebutsheni	ADV
wokufundwa	POSS03
ugxininiso	N11
phuhlisa	V
nokufundisa	ADV
ehla	V
ezizezi	REL
yokubekwa	POSS09
sokuphuhlisa	POSS07
lube	VAUX
wengxaki	POSS03
kwamaqumrhu	POSS15
kunamandla	COP
ngokukhula	ADV
nogawulayo	ADV
negqibeleleyo	ADV
sabahlali	POSS07
exesha	POSS06
yimfuno	COP
lwezisombululo	POSS11
utitshala	N01a
okuza	REL
ezingqinisisekayo	REL
iintlobo	N10
nolungelelaniso	ADV
eyakhayo	REL
ngemfezeko	ADV
othe	REL
olubonisa	REL
woomasipala	POSS03
kwiziphatha-mandla	NLOC
ngolungiselelo	ADV
iingcebiso	N10
ezityhilwayo	REL
engabizi	REL
zokubusiphula	POSS10
ukutshona	N15
imvelaphi	N09
njengoceba	ADV
wezinto	POSS03
elithile	REL
kumathuba	ADVLOC
awaneleyo	REL
wanalo	COP
ingqwalaselo	N09
lwexabiso	POSS11
zefet	POSS10
ayizizo	COP
wolawulo	POSS03
ngokucutha	ADV
lamalungelo	POSS05
nakumaqela	ADV
enzakala	V
asoloko	REL
aphula	V
yothutho	POSS09
asinaxesha	COP
obohlukeneyo	REL
esintshaphantshapha	REL
zokunciphisa	POSS10
lukawonkwonke	POSS11
nokuphanda	ADV
kwifiptshathi	NLOC
sakudala	POSS07
enengxaki	REL
unyawo	N11
cinezela	V
olungezatsi	REL
nyibilika	V
wasemsebenzini	POSS03
eyonyulwe	REL
lakukhalaza	POSS05
mali	N00
nokuqeqesha	ADV
ibatho	N09
yokusebenza	POSS09
malungu	N06
phula	V
kwiingxoxo	NLOC
ngokuba	ADV
kwinguqu	NLOC
namanye	ADV
lwamazwe	POSS11
ngokwentlalo	ADV
yimikhuhlane	COP
lwengingqi	POSS11
irente	N09
nenxaxheba	ADV
ewaterberg	NLOC
ahlalelayo	REL
izenzo	N08
bubulungisa	COP
yolungiso	POSS09
eblowu	POSS06
komhlaba	POSS15
yokuguqulwa	POSS09
abasisiseko	REL
khawuleza	V
umcimbi	N03
kwidolophana	NLOC
okuqulathiweyo	REL
yokuveza	POSS09
kwelokishi	POSS15
imephu	N09
zokucwangcisa	POSS10
okuphucukileyo	REL
eziza	REL
yokuzintlitha	POSS09
yesibalo	POSS04
elidlamkisayo	REL
aphawulekayo	REL
kwizikolo	NLOC
ebonisa	REL
wokutyisa	POSS03
ngokwelizwe	ADV
imvula	N09
nezi	ADV
kweemathiriyeli	POSS15
kwale	POSS15
semali	POSS07
obunganyusa	REL
kwiingqesho	NLOC
emakwenziwe	REL
zeekliniki	POSS10
uze	VAUX
ngaloo	ADV
ngoluhlu	ADV
okunobakho	REL
ququzela	V
abamele	REL
samabanga	POSS07
msinyane	ADV
kwir&d	NLOC
omzantsi	POSS06
kungakhange	VAUX
uya	VAUX
ngokungayelelananga	ADV
isiphelo	N07
alunambane	COP
ezohlukeneyo	REL
ekwiimeko	COP
siyinkqubo-sikhokelo	COP
wokukhula	POSS03
oluziphatha	REL
efliptshathi	POSS06
zeenkonzo	POSS10
yimixholo	COP
amasebe	N06
kokusetyenziswa	POSS15
abangabantu	REL
ebhengeza	REL
icuba	N05
eninzi	ADJ09
anabasebenzi	REL
zokulingana	POSS10
entlantlu-mbini	REL
nezivumelwano	ADV
zamaphandle	POSS10
vula	V
zikwezinye	COP
hlanganisa	V
abahlala	REL
yokujolisa	POSS09
okuhlanganisa	POSS06
maninzi	ADJ06
luze	VAUX
iimpembelelo	N10
wonxibelelwano	POSS03
municipality	FOR
ebangqongileyo	REL
kwiinkcubeko	NLOC
kubanini	NLOC
sifo	N07
yi-inshorensi	COP
ophuhlisayo	REL
bamaqalela	POSS14
yokuqhutywa	POSS09
wedemokhrasi	POSS01
esithile	REL
enqabileyo	REL
neenkuthazo	ADV
neza	ADV
kufuphi	ADV
lwesininzi	POSS11
wasekuhlaleni	POSS03
ekume	REL
kweekomiti	POSS15
lokugqithisa	POSS11
olunobulungisa	REL
ocetywayo	REL
abanaxanduva	COP
eyithintelayo	REL
kunebhaskithi	ADV
magalelo	N06
ngokuphathelelene	ADV
ekhule	REL
yanamagunya	POSS09
orhwebo	POSS06
magqabantshintshi	N06
kowiso-mthetho	POSS15
enoncedo	REL
enamaqela	REL
akamhlanga	COP
yamanye	POSS04
olusandula	REL
ozifunayo	REL
yasebrithani	POSS09
kumalungelo	NLOC
abancinci	ADJ02
lama-35	POSS05
esinzulu	REL
acwangciselweyo	REL
zokutshintsha	POSS10
kangakanani	ADV
yokucwangcisa	POSS09
states	NPP
kunakwiingxaki	ADV
ephumelelayo	REL
planning	FOR
necwecwe	ADV
lamntu	POSS05
kwiintlangano	NLOC
utyalo-mali	N11
nokuphilisana	ADV
wokusoloko	POSS03
nongcoliseko	ADV
onke	PROQUANT06
umququzeleli	N01
obugqithisileyo	REL
bakhulu	COP
chaza	V
nakwimizi-mveliso	ADV
lomsetyenzana	POSS05
nokufana	ADV
abathetha	REL
o.k.t.	ABBR
elingafanelekanga	REL
isangqa	N07
naxesha	ADV
uzalisekiso	N11
nesaleko	ADV
lonikezelo	POSS05
kakubi	ADV
ngokubhekisele	ADV
ulibaziseko	N11
zangasese	POSS10
kwizinga	NLOC
nokuba	ADV
umvuzo	N03
kwezo	ADVLOC
lwakutsha	POSS11
lifutshane	COP
phezulu	ADV
enokwenzeka	REL
elinye	ADJ05
kweenkcukacha	POSS15
iingxoxo	N10
kwemilinganiselo	POSS15
oluqhutywe	REL
u-umzimvubu	N01a
unawo	COP
esiphuhliswe	REL
nokunxulumana	ADV
ngobungqina	ADV
zokuxhobisa	POSS10
banako	COP
bewadi	POSS02
vota	V
ngokusebenzisa	ADV
olawulayo	REL
nenkqubo-sikhokelo	ADV
okunokuxhuzula	REL
ngqiqo	N09
abangenamisebenzi	REL
lisiya	VAUX
odliwano-ndlebe	POSS06
gwenxa	ADV
nokukhuthazwa	ADV
amanzi	N06
oluzele	REL
zengxaki	POSS10
ukrwaqulo	N11
lengeniso	POSS05
amajelo	N06
lwendawo	POSS11
budgeting	FOR
lokungoneliseki	POSS11
act	FOR
wamalungiselelo	POSS03
kwipolitiki	NLOC
e-idp	POSS06
kokuqala	POSS15
sisonke	PROQUANT07
engenaluphazamiseko	REL
uye	VAUX
ezinamathuba	REL
wemfundo	POSS03
zolonwabo	POSS08
entweni	NLOC
ulwelo	N11
chanaba	V
imiceli-mngeni	N04
zenyathelo	POSS08
ntsokotha	V
ejolise	REL
ngumthetho	COP
anezakhono	REL
unesaziso	COP
ngokuqwalasela	ADV
avelileyo	REL
lungelelwano	N11
umz.	ABBR
ababakhonzayo	REL
ibe	COP
abanokuthetha	REL
engqiyame	REL
caphula	V
abathathe	REL
nokuzithemba	ADV
neepatheni	ADV
lwengqesho	POSS11
yokuncedisa	POSS04
ibali	N05
lwezimbo	POSS11
okusemthethweni	REL
kanjalo	ADV
alawula	REL
lunezixhobo	COP
lokusebenza	POSS11
yaze	VAUX
e-1	REL
ilinyathelo	COP
esixhenxe	REL
bokwenza	POSS14
kukhathalelo	NLOC
engeyiyo	REL
zokuphumeza	POSS10
yangaphakathi	POSS09
banesabelo	COP
zokuqhuba	POSS10
linye	ADJ05
wabemi	POSS03
yokukhohlakala	POSS09
ogqithisela	REL
zojoliso	POSS10
ziziphumo	COP
anxulumene	REL
phantsi	ADV
ama-33%	N06
lokunikeza	POSS11
nakwiiprojekthi	ADV
mngxuma	N03
sabantu	POSS07
kodwa	CONJ
nokudambisa	ADV
kubulunga	NLOC
umhla	N03
semthethweni	NLOC
zolwazi	POSS10
kawonkewonke	POSSKA
izicwangciso-qhinga	N08
i-powerpoint	N09
nasekufundiseni	ADV
ngokuqinisekileyo	ADV
zabantwana	POSS10
ekulula	REL
ngenani	ADV
abazibeke	REL
lumka	V
yokuziphatha	POSS09
unamaqela	COP
uvandlakanyo	N11
ikras	N09
onempembelelo	REL
bubungcali	COP
ngumphathiswa	COP
kweqela	POSS15
ngezibini	ADV
nequlethwe	ADV
abahlali	N02
eyakhiwe	REL
ngokubanika	ADV
okusondeleyo	REL
ezendele	REL
ezingaphezu	REL
amahlanu	ADJ06
njengearhente	ADV
njengomahlulelane	ADV
abamakhaya	REL
abathathi-nxaxheba	N02
leegadi	POSS05
nabanokukulindela	ADV
okwelizwe	ADV
kwi-10	NLOC
isikolo	N07
nasekuhanjisweni	ADV
elikhethiweyo	REL
lomthetho	POSS05
kwicala	NLOC
uxanduva	N11
nokubeka	ADV
ezabonakala	REL
owesibini	REL
ngokugcweleyo	ADV
kokubuyiselwa	POSS15
komiti	N10
bemi	N06
ezingomgaqo-siseko	REL
ngokuchanekileyo	ADV
nee-mec	ADV
elikwisicwangciso	REL
hamba	V
qonda	V
ngokusebenza	ADV
ngokuphikisayo	ADV
umboneleli	N01
chwetheza	V
kwemingeni	POSS15
abacwangcisi	N02
kwindlu	NLOC
nakuba	ADV
ezisezingqondweni	REL
bhida	V
alinganayo	REL
olunye	ADJ11
ntlanganiso	N09
nevulelekileyo	ADV
samagunya	POSS07
wephepha	POSS03
intlonipho	N09
inkqubo	N09
leqela	POSS05
ngokubonakalayo	ADV
ezele	REL
kwiveki	NLOC
yokubonisa	POSS09
lwamaxabiso	POSS11
vavanya	V
empixano	POSS06
bengingqi	POSS02
kwezobugcisa	POSS15
wempuku	POSS03
eziqaqambayo	REL
zintlu	N10
iinkundla	N10
elimele	REL
nokuhlanganiselwa	ADV
ngokuhlangeneyo	ADV
kungumqukumbelo	COP
nokuncedisa	ADV
kubhetele	COP
iintelekelelo	N10
ngokungenisa	ADV
nesimo	ADV
lwesishwankathelo	POSS11
elikhulu	ADJ05
xhoma	V
ezinamandla	REL
iklinikhi	N09
kwicwecwe	NLOC
zabasebenzi	POSS08
ungquzulwana	N11
abanokuthatha	REL
lommandla	POSS11
ziyimfuneko	COP
ezahlukeneyo	REL
abaselungelweni	REL
leefama	POSS05
sisicwangciso-qhinga	COP
ekhawulezileyo	REL
nomgangatho	ADV
lama-44	POSS05
njengezinto	ADV
elibandakanyekayo	REL
ocwangciso	POSS06
ilizwe	N05
ezisekwe	REL
okungafaniyo	REL
ngokubeka	ADV
abavale	REL
yayo	POSS04
ingumthetho-siseko	COP
lweekomiti	POSS11
kwamanqanaba	POSS15
ezinoxanduva	REL
kwemveliso	POSS15
isakhelo	N07
inkuthalo	N09
okubachaphazelayo	REL
emisebenzi	POSS06
belizwe	POSS14
kwengxelo	POSS15
imingcipheko	N04
i-logframe	N09
yemfano	POSS09
kuye	VAUX
mangaphi	ADJ06
sele	VAUX
zokufuna	POSS10
lwesine	POSS11
kwinyanga	NLOC
kunyanzeliso	NLOC
nawowiso-mthetho	ADV
egqibele	REL
wemveliso	POSS03
nokucela	ADV
engenamkhethe	REL
eziphi	REL
ngeqela	ADV
kunonophelo	NLOC
esibalulekileyo	REL
okuyimpumelelo	REL
kwizicwangciso	NLOC
ezisisikhumbuzo	REL
kumaphandle	ADV
owenziwa	REL
ukhuphiswano	N11
koncedo	POSS15
ekwabelwana	REL
ephawulwe	REL
okuqwalasela	POSS06
oselukhona	REL
engezantsi	REL
nezidingo	ADV
kroba	V
okusilelayo	REL
phakamisa	V
namandla	ADV
lombane	POSS05
kwi-community-based	NLOC
amakhaya	N06
nozalisekiso	ADV
amanyathelo	N06
asiyi	VAUX
njengomthengi	ADV
nakumthetho	ADV
eziyikapitali	REL
nangamaxwebhu	ADV
kwakhe	POSS15
wabahlawuli	POSS03
nabanye	ADV
okunokuphunyezwa	REL
igatya	N05
kwiphungulo	NLOC
yabasebenzi	POSS09
abanini	N02
esemgangathweni	REL
kokwenzekayo	COP
eququzelelayo	REL
okuzigqiba	POSS06
berhafu	POSS02
nemfundo	ADV
kwisixa	NLOC
oluphakamileyo	REL
ungayinkokheli	COP
unjani	ADV
nezixokelelwano	ADV
kwimigangatho	NLOC
nobonelelo	ADV
onesidima	REL
lobungcali	POSS11
okulingeneyo	REL
noluphi	ADV
simana	VAUX
nabaxhasi	ADV
nomzamo	ADV
ngokuhlanganyela	ADV
nomasipala	ADV
pele	NPP
kokuyibona	POSS15
kwinyathelo	NLOC
sokuchola-cholwa	POSS07
kuko	PROEMPLOC
nezisebenzisa	ADV
obizwa	REL
olwaneleyo	REL
yeka	V
ephilayo	REL
elalini	NLOC
kwezengqesho	POSS15
neemfuneko	ADV
esingentla	REL
wokuqala	POSS03
sungula	V
sokulungisa	POSS07
lwamaqela	POSS11
lwesiphumo	POSS11
kweveki	POSS15
ngempiliso	ADV
yonxibelelwano	POSS09
edlulilelyo	REL
weofisi	POSS01
akuchazileyo	REL
2001	NUM
besibini	POSS14
zezindlu	POSS10
kulwaphulo	NLOC
iifreyimi	N10
engahoywanga	REL
zizixhobo	COP
ezimeleneyo	REL
amade	ADJ06
nokwakhiwa	ADV
chopha	V
wenene	POSS03
lwamakhosikazi	POSS11
abakumanqanaba	N02
ngokungalawuli	ADV
samancedo	POSS07
wamashishini	POSS03
ezigcinekileyo	REL
asixhenxe	REL
ngokucwangcisa	ADV
needolophu	ADV
bamadoda	POSS14
orongo	REL
ngumngeni	COP
nokwahlulwa	ADV
ngokuchasene	ADV
ebuyiselwayo	REL
nokuvunyelwana	ADV
zinkcukacha	N10
okumisela	REL
zeli	POSS08
nasiphina	ADV
ngemigangatho	ADV
kwikhontraka	NLOC
lokuhlalutya	POSS05
ezinemigodi	REL
ngezidingo	ADV
ixhala	N05
basemoutse	POSS02
ngeempawu	ADV
nemakatini	ADV
ezicacisa	REL
exwesileyo	REL
kras	ABBR
bolondolozo	POSS02
esizisa	REL
zokuhlala	POSS10
ngokwanelisayo	ADV
iqhutywayo	REL
kungenelo	NLOC
yinto	COP
yokulungelana	POSS09
ziimanejala	COP
kwisiqingatha	NLOC
angaba	REL
kwangoko	ADV
ngokwexesha	ADV
namaphetshana	ADV
phengulula	V
nomyinge	ADV
ecocekileyo	REL
iimbumba	N10
umjikelo	N03
vukela	V
avulekileyo	REL
nelinokusetyenziswa	ADV
evakalayo	REL
nokujikeleza	ADV
zoqoqosho	POSS10
ezinenzuzo	REL
dibana	V
lwemithetho-siseko	POSS11
kombane	POSS15
zexesha	POSS10
neziko	ADV
sezemali	POSS07
kwemivuzo	POSS15
lamanzi	POSS05
nale	ADV
nobanezayo	ADV
ngamava	COP
kwintsingiselo	NLOC
kunyaka-mali	NLOC
nokufumaneka	ADV
eziphila	REL
nangona	CONJ
kwimpilo	NLOC
ngobunini	ADV
kwamagunya	POSS15
mba	N03
olumanyanisiweyo	REL
yezempilo	POSS09
kwamatikiti	POSS15
ethubeni	NLOC
yamxhelo	POSS09
uhlalutyo	N11
kubasebenzi	NLOC
ngokucinga	ADV
olulolo	REL
olunzima	REL
njengesigqeba	ADV
yoogob	POSS09
yexesha	POSS09
ezinokhuselo	REL
ebeya	VAUX
nokulinganisa	ADV
tsho	V
ezisisiseko	REL
sisicwangciso-nkqubo	COP
nokuxhasa	ADV
hlangabeza	V
ngezigqibo	ADV
lolondolozo	POSS11
esekiweyo	REL
ephambili	REL
iipropati	N10
kubunako	ADVLOC
ingxabano	N09
kunabanye	ADV
zomsebenzi	POSS10
kubumbano	NLOC
ziphi	INTER
osebenza	REL
zinganempembelelo	COP
ezichazwa	REL
lezopolitiko	POSS05
nge-hiv	ADV
lokulawulwa	POSS11
project	FOR
zezizwe	POSS10
benomsindo	COP
koluhlu	POSS15
ezibuyelelayo	REL
njengenkqubo	ADV
abasebenzisi	N02
luthungelwano	COP
umthengi	N03
koyedwa	ADVLOC
kwedemokrasi	POSS15
olujonge	REL
nentlanganiso	ADV
olubandakanyekayo	REL
i-10%	N09
fuma	V
nangesini	ADV
obushushu	POSS06
hleze	ADV
task	FOR
kulwakhiwo	NLOC
zokungafani	POSS10
khanya	V
xakeka	V
leminyaka	POSS05
engenamfihlo	REL
nebandakanya	ADV
kulwahlulelwano	NLOC
baninzi	COP
wokuzithandela	POSS03
elingumhlohli	REL
kunemisebenzi	ADV
obuphezulu	REL
ngokungenacala	ADV
abachaphazeleka	REL
womniki	POSS01
nezicwangciso	ADV
lemiba	POSS05
entle	ADJ09
esiphakathi	REL
labafundi	POSS05
ngokungqalileyo	ADV
ezizodwa	REL
ngokujikeleze	ADV
njengoko	ADV
nezalathisi	ADV
neemeko	ADV
yokugaya	POSS09
ezenzeke	REL
kwinzame	NLOC
mzobo	N03
bhekisa	V
ekarhulumente	REL
kumakhadi	NLOC
kumgaqo-siseko	NLOC
lokugqibela	POSS11
lwakuqala	POSS11
eziyimfuneko	REL
yimaphu	COP
kwi-lfa	NLOC
elichithwa	REL
kukumema	COP
phetha	V
lokuthobeka	POSS05
ngokuvakalisa	ADV
ngebatho	ADV
ngooceba	ADV
ngokwabo	ADV
uphononongo	N11
wayo	POSS03
-iinjongo	N10
ezingaqhubi	REL
engqinwa	REL
seplathinamu	POSS07
nakumgangatho	ADV
mdla	N03
abatyunjiweyo	REL
amagunya	N06
nakumsebenzi	ADV
yokuxoxa	POSS09
uyintombazana	COP
ezingavuselelekiyo	REL
ngokubakho	ADV
aneepotfoliyo	REL
ngokuqaphela	ADV
ephantsi	REL
ngabaphathi	COP
iinjongo	N10
zakhe	POSS10
yezi	POSS09
lweempendulo	POSS11
nangokwezivumelwano	ADV
noko	ADV
msetyenzana	N03
esinikeza	REL
intshukumo	N09
ukuqwalaselwa	N15
sokufakela	POSS07
unemfuno	COP
zabaphathi	POSS10
nangekho	ADV
neziphumo	ADV
irenti	N09
woshishino	POSS03
zokulinga	POSS10
nezokuhlala	ADV
ngabafazi	COP
nesantya	ADV
ubunkokeli	N14
isenzo	N07
ezidolophini	NLOC
kwabahlelelekileyo	POSS15
zenzeko	N08
velisa	V
beevenkile	POSS02
wokujonga	POSS03
ngokucwangciswa	ADV
zongquzulwano	POSS10
yokuthengiselana	POSS09
zasethekwini	POSS10
kwabasebenza	POSS15
okuncedisa	REL
ingubani	INTER
olunendleko	REL
ngokokuxhomekeka	ADV
samanqaku	POSS07
nakubasebenzi	ADV
kwe-inshorensi	POSS15
neethagethi	ADV
labathathi-nxaxheba	POSS05
eliphakathi	REL
zokufezekisa	POSS08
eyokuqala	REL
wesigqeba	POSS01
emveli	POSS06
esikolo	POSS06
njengabathengi	ADV
nangesidima	ADV
government	FOR
phakathi	ADV
ezihambelanayo	REL
likawonke-wonke	POSS05
lwazi	N11
for	FOR
wangoku	POSS03
ukunqongophala	N15
ngolawulo	ADV
tshintsho	N11
ngokuzimeleyo	ADV
vi	V
neegesi	ADV
neminyaka	ADV
result	FOR
baphantse	VAUX
balasela	V
ikhwelo	N05
izicangciso	N08
nentlawulo	ADV
abalawuli	N02
lweedolophu	POSS11
ngohlobo	ADV
lokuqwalaselwa	POSS11
nokukodwa	ADV
ngokwezimvo	ADV
elityala	REL
lokuhamba	POSS05
lentswela-ngqesho	POSS05
ezenza	REL
xhamla	V
uphengululo	N11
sokuqhutywa	POSS07
nokuzimela	ADV
olunjengeebhanki	REL
yezemali	POSS09
wongquzulwano	POSS03
umcwangcisi	N01
semanyano	POSS07
nenzuzo	ADV
zinako	COP
nokubuyiselwa	ADV
nezinako	ADV
wekomiti	POSS01
nesiphumo	ADV
ezingatshoni	REL
zocweyo	POSS10
simahla	ADV
nelekomiti	ADV
lesixokelelwana	POSS05
imizi	N04
ababandakanyekayo	REL
umthathi-nxaxheba	N01
anjengemibutho	REL
nokonga	ADV
imida	N04
ebekucetywe	REL
kwikomiti	NLOC
nokuzama	ADV
kulwenziwo-zigqibo	NLOC
embalwa	REL
lwabasebenzi	POSS11
ikhomishoni	N09
kwamasondo	POSS15
kwezili-15	NLOC
nabanikezeli	ADV
kwengama-50	NLOC
ikwayenye	COP
othetha-thethwano	POSS06
oluzifumana	REL
eziyimikhwa	REL
yokuphuculwa	POSS09
umthetho-siseko	N03
ngokushwankathela	ADV
idata	N09
eyinene	REL
zephondo	POSS10
yeenkqubo	POSS09
zokulawula	POSS08
ezihlanganiselweyo	REL
kwiindawo	NLOC
nalowo	ADV
nelinye	ADV
nonobhala	ADV
yewadi	POSS09
nolusebenzayo	ADV
yabantu	POSS04
ooceba	N02a
ephilileyo	REL
elincinci	ADJ05
njengezincedisi	ADV
elimalunga	REL
unqongophalo	N11
inyhikityha	N09
iidolophu	N10
okuvumela	REL
ubekhona	COP
nawabucala	ADV
okusisixa	REL
elinyusiweyo	REL
mpendulo	N09
thambeka	V
abathe	REL
ekhuselekileyo	REL
ubumxinwa	REL
ngena	V
angathathi	REL
nokubhekiselwa	ADV
nentetho	ADV
okuhamba	REL
areas	FOR
yobugcisa	POSS09
neempendulo	ADV
kuceba	NLOC
ayithethayo	REL
elinokufikelela	REL
echongwe	REL
unezabelo	COP
feza	V
ombane	POSS06
vuya	V
funeka	V
zazo	POSS10
ngefowuni	ADV
ongama-30	REL
kwilungelo	NLOC
ngokudlulele	ADV
eyandulela	REL
nezifunwa	ADV
nezamadoda	ADV
lubekufutshane	COP
kwemibutho	POSS15
yamatyala	POSS09
weenkcukacha	POSS01
phawula	V
lwemingeni	POSS11
i-lfa	N09
iphupha	N05
kwenene	POSS15
yintetho	COP
seengxowa-mali	POSS07
sokwandlaleka	POSS07
acele	REL
aphezulu	REL
elingathembekanga	REL
lwaphuhliwe	POSS11
9	NUM
kukamasipala	POSS15
ezinobunini	REL
zenkulungwane	POSS10
umcebisi	N01
nethuba	ADV
kwii-ofisi	NLOC
socwangciso	POSS07
walo	POSS03
okusisiseko	REL
athathwayo	REL
kumakhondo	NLOC
adala	REL
ezinomtyhi	REL
cela	V
ethumela	REL
bahlali	N02
lwengxelo	POSS11
amagqabantshintshi	N06
inamancedo	N09
afumane	REL
macala	ADV
iimemo	N10
enkulu	ADJ09
lixabiso	COP
olwakhiwe	REL
ezentlalo	REL
yikomiti	COP
zemiceli-mingeni	POSS10
wazo	POSS01
elisembindini	REL
yeeprojekthi	POSS09
ekujoliswe	REL
zezentlalo	POSS10
ofuna	REL
kubangcono	COP
nesondlo	ADV
kwintsebenziswano	NLOC
kwii-1950	NLOC
lweearhente	POSS11
ezahluka-hlukileyo	REL
ezisoloko	REL
kwiphondo	NLOC
inokwenzeka	COP
eyiyeyona	REL
ngokwakha	ADV
sidanga	N07
izicwangciso-nkqubo	N08
okudandalaziswe	REL
nikeza	V
mva	ADV
asezantsi	REL
ngokubanakho	ADV
oo-a	N02a
njengabasebenzi	ADV
measurable	FOR
omiselweyo	REL
ngelahleko	ADV
noqoqosho	ADV
ezantsi	ADVLOC
iindleko	N10
unganowiso-mthetho	COP
ubani	N01a
ngomgca	ADV
inxenye	N09
aziyiyo	COP
sabaniki	POSS07
zelizwe	POSS10
abasingeleke	REL
nakwizindululo	ADV
ezezimali	REL
edar	NLOC
phambili	ADV
ezivuselela	REL
nokungavisisani	ADV
engeniswa	REL
yesiqhelo	POSS09
nebhunga	ADV
esebenzayo	REL
relations	FOR
neyethuba	ADV
lobulunga	POSS05
enokubakho	REL
omhle	ADJ03
ngokubamba	ADV
yokudwelisa	POSS04
kwinkolo	NLOC
amathuba	N06
zikhona	COP
ingezantsi	REL
elilandelayo	REL
lwesikolo	POSS11
kuthethwano	NLOC
ngowe-1994	ADV
wenani	POSS03
zokuqeqesha	POSS08
nasekulweni	ADV
sokuzivavanya	POSS07
ngeziganeko	ADV
ngurhulumente	COP
isiganeko	N07
mars	NPP
elidityaniswe	REL
yeidp	POSS04
lwabemi	POSS11
ezibanjwa	REL
kokhathalelo	POSS15
ezikhethiweyo	REL
zalo	POSS08
isigunyaziso	N07
kumphetho	NLOC
ezilungele	REL
ngemihla	ADV
okubonwa	REL
efanele	REL
oyilwayo	REL
i-pcm	N09
nolwamaqela	ADV
lokunceda	POSS11
kwimephu	NLOC
sondela	V
isakhono	N07
lweziganeko	POSS11
hlenga	V
kwimpatho	NLOC
elinyukayo	REL
aphakame	REL
nezinika	ADV
zokuzithandisa	POSS08
okwiphepha	REL
yothungelwano	POSS09
nokukwazi	ADV
lima	V
yindima	COP
indawo	N09
isisixhobo	COP
phembelela	V
iintlanganiso	N10
abanikwe	REL
working	FOR
eyilwayo	REL
uyingozi	COP
gxila	V
olomeleleyo	REL
esingqalileyo	REL
kwembali	POSS15
njengabathunywa	ADV
nezimali	ADV
nezimbo	ADV
ngenyanga	ADV
kwiimfuno	NLOC
nemo	ADV
ababi	COP
ophuhliso	POSS06
wokusebenza	POSS03
umbindi	N03
zokuphila	POSS08
ephakathi	REL
i-aicdd	N09
ifuthe	N05
kwemigaqo-nkqubo	POSS15
abamalunga	REL
igolide	N09
linyathelo	COP
emdleni	NLOC
lokufikelela	POSS05
ezithatyathiweyo	REL
sentlanganiso	POSS07
omawuyinxibe	REL
nokubonelela	ADV
ngokungananzwa	ADV
nesinye	ADV
oluma	REL
ezazingalindelwanga	REL
musa	VAUX
ngezizathu	ADV
zabaqeshwa	POSS08
nangeendlela	ADV
nolu	ADV
zeempiliso	POSS10
kangako	ADV
lungiselelo	N11
banzi	REL
zonkcenkcesho	POSS10
lesicwangciso	POSS05
abamhlophe	REL
lokuzihlaziya	POSS11
ku-1.1.1	NLOC
unendlu	COP
sithuba	N07
kuwo	PROEMPLOC
kwimozulu	NLOC
migaqo-nkqubo	N04
zomjikelo	POSS10
elimisiweyo	REL
engxabalazele	REL
kwentengo	POSS15
kobume	POSS15
abangama-54	REL
bemfundo	POSS14
njengoqoqosho	ADV
kwinxalenye	NLOC
namagalelo	ADV
nobunkokeli	ADV
lokufa	POSS05
neziqhamo	ADV
lasemzantsi	POSS05
kophengululo	POSS15
obomi	POSS06
iindlela	N10
nabaphathiswa	ADV
isininzi	ADJ07
ezibandakanywe	REL
nenkcitho	ADV
esithe	REL
funza	V
kubandakanyekayo	REL
nesikhokelo	ADV
faka	V
kwezakhiwo	POSS15
nalwazi	COP
ekumsebenzi	NLOC
leyo	CDEM09
nezinokulinganiswa	ADV
lwangasese	POSS11
nezifukamisi	ADV
mthetho	N03
ozalana	REL
nokuqesheka	ADV
kwangaphambili	ADV
nommandla	ADV
yoqoqosho	POSS04
ophindaphindekayo	REL
lomnye	POSS11
lwemigqaliselo	POSS11
iilephtophu	N10
representative	FOR
abahlelelekileyo	REL
ebangelwa	REL
ngokwalo	ADV
abendeleyo	REL
elithe	REL
yezentlalo-ntle	POSS04
zokudibanisa	POSS10
wokhuselo	POSS03
njengemfihlo	ADV
okwenziwa	REL
eqinisekisa	REL
okukwachazwa	REL
naleyo	ADV
nokhenketho	ADV
izicwangciso	N08
izincedisi	N08
abarhwebi	N02
ngebhunga	ADV
kwamandla	POSS15
bangabi	COP
aphathekayo	REL
njengabantu	ADV
eziqhubelekayo	REL
unamathelwano	N11
zonyulo	POSS10
nokususwa	ADV
olubhekela	REL
lwamacandelo	POSS11
ngulo	COP
ukhokelo	N11
obulungileyo	REL
nesebenzisa	ADV
zokubandakanya	POSS10
embombo	POSS06
oluxeliweyo	REL
kwiiklasi	NLOC
ngolu	ADV
nakumasipala	ADV
yoku	POSS09
ahlukeneyo	REL
ngokuphambili	ADV
lamakhaya	POSS05
zohlahlo	POSS10
umthwalo	N03
nokuphuhla	ADV
qoqosho	N11
nenobulungisa	ADV
impikiswano	N09
nangeengxaki	ADV
esinjengebhodi	REL
kwedemokhrasi	POSS15
aidscouncil	FOR
ucweyo	N11
ezineziphumo	REL
ngumbono	COP
uvelwano	N11
izibane	N08
yotyalo-mali	POSS04
alungele	REL
kwimiceli-mngeni	NLOC
izithuthi	N08
kwinjongo	NLOC
bophuhliso	POSS02
uphuhliso	N11
abasenokwenzakala	REL
wakuba	VAUX
inganesikhululo	COP
kuhlolo	NLOC
nasemzantsi	ADV
zeendlela	POSS10
abachaphazelekayo	REL
awamaphondo	REL
ngeezimvo	ADV
anyiniweyo	REL
elincomekayo	REL
inkululeko	N09
nase-indiya	ADV
nokululeka	ADV
olusulungekileyo	REL
okupheleleyo	REL
khankanya	V
inkonzo	N09
akasoze	VAUX
ababini	ADJ02
partnerships	FOR
es	NPP
xela	V
nenkxaso	ADV
zokuziphatha	POSS10
ongezantsi	REL
nomnatha	ADV
yobulunga	POSS09
ngentlanganiso	ADV
ephila	REL
nangemithetho-siseko	ADV
ngokwezimali	ADV
luncinane	ADJ11
inani	N05
kwizakhono	NLOC
zepropati	POSS10
zalathiso	N08
bhena	V
ezimbini	ADJ10
abalindele	REL
yenguqu	POSS09
ozayo	REL
neentloko	COP
waze	VAUX
abonelelwe	REL
kwizibini	ADJLOC
nokubandakanyeka	ADV
kwi-municipal	NLOC
esekelwe	REL
njengomzekelo	ADV
esempuma-koloni	REL
ngezimali	ADV
esisetyenziswayo	REL
zona	PROQUANT08
abalungileyo	REL
nokuthakazelela	ADV
lwazo	POSS11
zokuphuhliswa	POSS10
abangamalungu	REL
nophononongo	ADV
unoxanduva	N11
kwezindlu	POSS15
ngethemba	ADV
asakhulayo	REL
wokuphuhlisa	POSS01
thathela	V
oo-b	N02a
amakhulu	ADJ06
nonyaka	ADV
izinti	N10
zokutya	POSS10
urhwaphilizo	N11
yethu	POSS09
ntsompotha	V
yorhwebo	POSS09
asiyonkqubo	COP
awona	PROEMP06
ngemva	ADV
oonompilo	N02a
nyuka	V
amanqanam	N06
kumanqanam	NLOC
ngabanikezeli	COP
ubulunga	N14
womnikezeli	POSS03
ngokusetyenziswa	ADV
ngokwezentlalo	ADV
zeekomitana	POSS10
nezezithuba	ADV
kwexesha	POSS15
nabanomdla	ADV
elingangonyaka	REL
ikakhulu	REL
nangokwentlalo	ADV
kubonelelo	NLOC
ngamasebe	ADV
ezilinywayo	REL
nezikuvunayo	ADV
29(b)	NUM
asemthethweni	REL
umntwana	N01
nabachwethelwe	ADV
khulisa	V
ngemibuzo	ADV
ukungabinabulungisa	COP
lwesikhundla	POSS11
ngeentlobo	ADV
kumasipala	NLOC
esiphakame	REL
namava	ADV
ezinikezelwayo	REL
wasemzantsi	POSS01
koomama	NLOC
asia	NPP
iqumrhu	N05
aquka	REL
ngokuhamba	ADV
ezifumaneka	REL
amakhadi	N06
nxibelelana	V
eqhubekekayo	REL
kokuhanjiswa	POSS15
lokwakha	POSS05
iimfuno	N10
oluthintela	REL
efunwayo	REL
zokuyilandelelanisa	POSS08
liziko	COP
nemivuzo	ADV
ase-afrika	POSS06
nakweliphi	ADV
isixa	N07
qoshela	V
esinenkathalo	REL
engundoqo	REL
nokubonisana	ADV
gama	N00
neletsema	ADV
izithethe	N08
iminqophiso	N04
axhasayo	REL
inegalelo	COP
zii-inshorensi	COP
kweemkcukacha	POSS15
aba-4	REL
oluqondwayo	REL
kumacandelo	NLOC
nabaquka	ADV
lilungu	COP
yenyathelo	POSS09
koqoqosho	POSS15
kolwabiwo	POSS15
engahlukanisi	REL
ngokugqwesayo	ADV
imithetho	N04
kwingxoxo	NLOC
abanokuthi	REL
zokwenza	POSS10
abafundi	N02
buyisa	V
zimalunga	COP
olufanelekileyo	REL
entsha	ADJ09
zokusombulula	POSS10
nolwaphulo-mthetho	ADV
lisesikweni	REL
nobezoqoqosho	ADV
kolimo	POSS15
njenge-'chapter	ADV
lezifundo	POSS05
esiphakamileyo	REL
oburhulumente	REL
kumsebenzi	NLOC
okubuyelelwayo	REL
aneemfuno	COP
malisoloko	VAUX
yezithuba	POSS04
abathatha	REL
ukuboleka	N15
abangama-afrika	REL
efikelela	REL
unyaka	N03
kuzwelonke	NLOC
abasisigidi	REL
zemimandla	POSS08
encinci	ADJ09
wokuseta	POSS03
labaxumi	POSS05
ze-cbp	POSS08
sokuza	POSS07
yinkcitho	COP
visisana	V
lwe-seymour	POSS11
wokuqinisekisa	POSS03
elibekiweyo	REL
zeendibano	POSS10
eyindima	REL
nowokuba	ADV
ikamva	N05
kubupolisa	NLOC
neentlanganiso	ADV
ngokubhalela	ADV
yebroadband	POSS09
emsebenzini	NLOC
oomahlulelane	N02a
nabantwana	ADV
nokuphumelela	ADV
nokuvuleleka	ADV
fuduka	V
aneengxaki	REL
kuqeqesho	NLOC
awo	POSS06
ii-sdip	N10
xhalaba	V
ezibhaliweyo	REL
khathaza	V
namaqabane	ADV
lokwandisa	POSS05
yeentlanganiso	POSS09
2	NUM
yokuqonda	POSS09
onomsindo	REL
ngokwesi	ADV
ezimvo	POSS06
isikhalazo	N07
owodwa	REL
yasemaphandleni	POSS04
kumazantsi	NLOC
elinganisayo	REL
namashisini	ADV
bekunye	COP
bubuchule	COP
obufunekayo	REL
igama	N05
abakhethelwe	REL
ezinokuthi	REL
akuzange	VAUX
ngenkqubo	ADV
isidingo	N07
banoxanduva	REL
abalikhethayo	REL
namavolontiya	ADV
okwendeleyo	REL
lepropati	POSS05
seli	POSS07
kungayo	COP
owenziwe	REL
kokufumana	POSS15
4	NUM
cutha	V
kwiziganeko	NLOC
womsebenzi	POSS03
yesini	POSS09
yobutyebi	POSS04
soqhagamshelwano	POSS07
ngobume	ADV
nokutyala	ADV
ingasesinye	COP
nomnikezeli	ADV
yolonwabo	POSS09
lokugqitywa	POSS05
awokukunceda	REL
ziileta	COP
iseti	N09
nokusebenzisana	ADV
umphetho	N03
lonke	PROQUANT05
thelekisa	V
ngumba	COP
okulinganiswayo	REL
ngendlela	ADV
ephakamileyo	REL
akusoze	VAUX
empumelelo	POSS06
kwekontrakthi	POSS15
okuphambili	REL
yemingcipheko	POSS09
yeemveliso	POSS09
zizalathisi	COP
izincomo	N10
ingumfuziselo	COP
banokwazisa	COP
ilahle	N05
izicwangciso-buqili	N08
ezinjengokuqokelelwa	REL
obufikelela	REL
nemibutho	ADV
lwethuba	POSS11
abanye	ADJ02
achazwe	REL
izakhelo	N08
phetshana	N05
imifanekiso	N04
eenkonzo	POSS06
eyantlukwano	REL
weengcali	POSS03
lomgangatho	POSS11
lunamazinga	COP
nobuncinane	ADV
xanduva	N11
aqesha	REL
inkoliso	N09
obusetyenziwe	REL
bedatha	POSS14
lamashishini	POSS05
emincinci	ADJ04
nento	ADV
bobabini	PROQUANT02
wengxoxo-mpikiswano	POSS03
indlebe	N09
senyathelo	POSS07
basematyotyombeni	POSS02
bemvelaphi	POSS02
kwehiv	POSS15
kwiqela	NLOC
khokelela	V
nezezicwangciso	ADV
yomvuzo	POSS04
libhunga	COP
bokuthatha	POSS14
eliphikisana	REL
umboniso-ngcaciso	N03
nawo	ADV
kwamathuba	POSS15
phola	V
nokungenelela	ADV
ezikhulu	ADJ08
bee-1980	POSS02
exinene	REL
neyureniyamu	ADV
lwenkqubo	POSS11
njengolwamkelekileyo	ADV
aphandwayo	REL
kukuthi	COP
abakhubazekileyo	REL
gxeka	V
oluthe	REL
nezithili	ADV
kwisizukulwana	NLOC
zezixhobo	POSS10
kweli-15	NLOC
singaphezu	COP
zopolitiko	POSS10
onwaba	V
qhubela	V
maxa	N06
ngcono	ADV
bandakanya	V
iincwadi	N10
umgqatswa	N01
ubuhlanga	N14
yantlukwano	N00
zequmrhu	POSS10
iimbono	N10
komgaqo-siseko	POSS15
saza	V
yabathunywa	POSS09
lonxulumaniso	POSS05
yebhanki	POSS09
nezibhedlele	ADV
lesithathu	POSS05
nokuviwayo	ADV
miceli-mngeni	N04
nomkhethe	COP
ngowe-2004	ADV
sezemfundo	POSS07
nobunini	ADV
lwemibhobho	POSS11
nabathathi-nxaxheba	ADV
ezinzulu	REL
zayo	POSS10
kwakunjalo	ADV
kwii-idp	NLOC
ngendawo	ADV
isazobe	N07
onamagunya	REL
ilulwahlulelwano	COP
lusisigxina	COP
ukrwada	COP
nokufikelela	ADV
kwilungu	NLOC
jonga	V
nyanga	N09
ngamazwi	ADV
nokungabi	ADV
nebala	ADV
wenkxaso-mali	POSS01
iziqulathe	N08
amane	ADJ06
ngokubanjwa	ADV
]	PUNC
yarhoqo	POSS09
ulondolozo	N11
fana	V
uqhagamshelwano	N11
umonakalo	N03
ezixubeneyo	REL
ngokwezizwe	ADV
edityanisiweyo	REL
neeshedyuli	ADV
kwixa	NLOC
elinyuka	REL
kukude	COP
nekhaya	ADV
amacala	N06
londoloza	V
lwemisebenzi	POSS11
olo	CDEM11
finance	FOR
nothakazelelo	ADV
zacalanye	POSS08
osekelwe	REL
lokusingqongileyo	POSS11
u-powerpoint	N01a
yokufaka	POSS09
yokusika	POSS09
nobungakanani	ADV
sigaba	N07
dlala	V
okusingela	REL
iinkalo	N10
nangezinto	ADV
namaxesha	ADV
ngokwelizwi	ADV
kwezemfundo	NLOC
ngoko	ADV
nasekuphenduleni	ADV
lokuqhutywa	POSS05
abaziqeshileyo	REL
zamawa	POSS10
basezitalatweni	POSS02
sisininzi	COP
oovimba	N02a
iileta	N10
abengawona	REL
unemithombo	COP
inkcukacha	N09
yemidla	POSS04
se-idp	POSS07
umsantsa	N03
komyinge	POSS15
nokuvavanya	ADV
obelusenza	REL
angundoqo	REL
unobangela	N01a
nokusasazwa	ADV
sokusuleleka	REL
abakwingingqi	REL
ilifa	N05
nemigodi	ADV
ematankini	NLOC
amaqela	N06
zoqoqsho	POSS10
nabavelisi	ADV
okuthe	REL
nokusebenza	ADV
kwekheshi	POSS15
ezicingelwe	REL
iinguqu-nguquko	N10
sayi	V
ezigciniweyo	REL
lukruthwa-kruthwano	COP
mababe	COP
njengamahlwempu	ADV
echonga	REL
olungasentla	REL
of	FOR
okuqala	POSS06
lumele	VAUX
emibini	ADJ04
kwaphakathi	ADV
ii-venn	N10
nesicwangciso	ADV
kwabamnyama	POSS15
luni	INTER
ngemigaqo-nkqubo	ADV
intsilelo	N09
lokungabikho	POSS05
ngokuhambisana	ADV
soku	POSS07
somda	POSS07
isibini	N07
oqwalasela	REL
nempumezo	ADV
zobunkokeli	POSS08
befama	POSS02
nokwahluka	ADV
ekumgangatho	REL
ngokuzeleyo	ADV
lukweli	REL
development	FOR
yi-aicdd	COP
engqalileyo	REL
yokungawini	POSS09
de	VAUX
zeeyunithi	POSS10
izizathu	N08
kobunzima	POSS15
thi	V
kwezepolitiki	POSS15
welungu	POSS03
eentlanga	POSS10
oluya	REL
zengingqi	POSS10
ngokuqhubekekayo	ADV
zokunxiba	POSS10
lwekapitali	POSS11
lokuphuhlisa	POSS05
kwizimali	NLOC
eveliswe	REL
ahlukahluka	V
ngothungelwano	ADV
olusimahla	REL
zinjalo	COP
utshintsho	N11
bebhunga	POSS02
unyulo	N11
kwimbali	NLOC
kamva	ADV
ezisimahla	REL
nabucala	ADV
abaziqhuba	REL
bokuzalisekiswa	POSS14
woludwe	POSS03
intle	COP
neepeni	ADV
zokwandisa	POSS10
kwegesi	POSS15
multi-year	FOR
i-intanethi	N09
esijolisa	REL
yeemanyano	POSS04
neququzelelwa	ADV
wesibini	POSS03
ngobandakanyo	ADV
elithetha	REL
ngqonga	V
kungevoti	COP
lingana	V
eyonganyelweyo	REL
nokubhideka	ADV
kwenye	ADJLOC
1.1	NUM
ubunkokheli	N14
nokuwavumela	ADV
ingumnini	COP
kwisambuku	NLOC
umnxeba	N03
kunikezelo	NLOC
imana	VAUX
imicinga	N04
yohlahlo	POSS09
nokunyuka	ADV
engahlulwanga	REL
ligunya	COP
enokusetyenziswa	REL
futhi	CONJ
ziya	VAUX
njengabahlali	ADV
ngempumelelo	ADV
zenxaxheba	POSS10
:	PUNC
yothethathethwano	POSS09
caca	V
lukawonke-wonke	POSS11
okwesithathu	ADV
land	FOR
key	FOR
esivela	REL
ngomgangatho	ADV
lokhathalelo	POSS11
ileta	N09
elininzi	ADJ05
lokholo	POSS05
ukungabinamfihlo	COP
kwemidla	POSS15
ngumxholo	COP
seqela	POSS07
zoomasipala	POSS10
bukhona	COP
kwi-idp	NLOC
wesithathu	POSS03
acts	FOR
olungathatyathwa	REL
wepotfoliyo	POSS03
lungelelana	V
obuphantsi	REL
inkcubeko	N09
yokuphatha	POSS09
ubungakanani	ADV
nengomso	ADV
bothutho	POSS14
ezinobunganga	REL
ilizwi	N05
nokwabelana	ADV
ngokuxhasa	ADV
ngorhafiso	ADV
okholisa	REL
mcimbi	N03
yamashishini	POSS04
yemingeni	POSS09
kokuthatha	POSS15
kwamazinga	POSS15
nokuzalisekisa	ADV
abangawaziyo	REL
lamabhinqa	POSS05
lukanobhala	POSS11
abasebatsha	ADJ02
yolutsha	POSS04
kuluxanduva	COP
isitokhwe	N07
xhathisa	V
noceba	ADV
nasekubunjweni	ADV
zenkqubo	POSS08
eziva	REL
umntu	N01
ii-kra	N10
kubanegalelo	COP
iqela	N05
ikopi	N09
liqela	COP
eengxaki	POSS06
kumanqanaba	NLOC
ngokungafanelekanga	ADV
yokwazisa	POSS09
ngenqaku	ADV
obungaphaya	REL
olujongene	REL
kwiphetshana	NLOC
sezakhono	POSS07
ugesi	N01a
emakhaya	NLOC
kolwazi	POSS15
ekungasiwa	REL
umthumeli	N01
oziva	REL
sokufikelela	POSS07
yomzantsi	POSS09
lwamajelo	POSS11
lwezakhiwo	POSS11
eziphathelelene	REL
lwasemakhaya	POSS11
ethethwa	REL
eyenza	REL
nangaphezulu	ADV
wasekhaya	POSS01
wenkxaso	POSS01
yokungasebenzi	POSS09
maziko	N06
elingakhethi	REL
sempilo	POSS07
owongezelelekileyo	REL
nangentlonipho	ADV
wembali	POSS03
unethuba	COP
ade	VAUX
ngeempiliso	ADV
soluntu	POSS07
gaya	V
kwawo	POSS15
bengenamali	COP
amalinge	N06
lweenzululwazi	POSS11
kumntuni	NLOC
ngokwasezimalini	ADV
ngaxeshanye	ADV
nentsebenziswano	ADV
lwamalungelo	POSS11
inzame	N09
zesifuba	POSS08
kumabhinqa	NLOC
leengxoxo	POSS05
ngokucotha	ADV
corporation	FOR
nokujongana	ADV
zisisakhelo	COP
eveliswayo	REL
lwempilo	POSS11
naziphi	ADV
ezingamaqalela	REL
ityala	N05
thungelana	V
soguquko	POSS07
sonyaka	POSS07
ngenxa	CONJ
athile	REL
kwinkcitho	NLOC
elawula	REL
qhawula	V
chaphaza	V
eyenziweyo	REL
amazinga	N06
yedemokrasi	POSS09
oomasipala	N02a
izabelo	N08
ngombuzo	ADV
abawaziyo	REL
landela	V
localucalulo	POSS05
lokuba	POSS05
okwangoku	ADV
nezenza	ADV
ekusaxoxwayo	REL
iikpi	N10
ngophuhliso	ADV
obomeleleyo	REL
ngusodolophu	COP
ngokusondeleyo	ADV
lwedemokhrasi	POSS11
enoxolo	REL
yimpumelelo	COP
zoonomathotholo	POSS08
kwilizwekazi	NLOC
okuphume	REL
kubanempembelelo	COP
nomanejala	ADV
olunokunceda	REL
ngokuthobelana	ADV
zeseli	POSS10
kutsha	ADV
ekomiti	POSS06
laza	VAUX
angqalileyo	REL
gqibela	V
zokuqala	POSS10
osebenzayo	REL
banekratshi	COP
yingeniso	COP
kwi-swot	NLOC
eziphathekayo	REL
lisezantsi	COP
zaye	VAUX
wotshintsho	POSS01
lwelitye	POSS11
iingeniso	N10
eyabasetyhini	REL
nowangaphambili	ADV
nomnye	ADV
nkokheli	N09
amapolisa	N06
yempilo	POSS04
ezinokufikelela	REL
okukhula	POSS06
nkqu	ADV
seshoni	N00
njengoyena	ADV
fomu	N00
omthetho	POSS06
tyumba	V
semifuno	POSS07
kumanqaku	NLOC
ingqalelo	N09
isiphatha-mandla	N07
yolumano-ndlebe	POSS09
exhasa	REL
zeengcebiso	POSS10
esidume	REL
kwamakhosikazi	POSS15
namaqondo	ADV
isondlo	N07
inkxaso	N09
ezi-3.2	REL
nethembekileyo	ADV
ezintsonkothileyo	REL
anelisa	V
awunamali	COP
hlawula	V
yokuyigcwalisa	POSS09
inkulu	ADJ09
esenza	REL
uphicotho	N11
yesibini	POSS09
onakho	REL
okuphila	POSS06
asenokuba	COP
idesika	N09
lokuphila	POSS05
ngokwemiqathango	ADV
kubenzima	COP
bowe-1980	POSS14
novandlakanyo	ADV
yenkonzo	POSS09
lokulawula	POSS11
elingenamkhethe	REL
idp	ABBR
yingxaki	COP
ngezo	ADV
yokomeleza	POSS09
nezokubuyiswa	ADV
ebiphawuliwe	REL
wangoomasipala	POSS03
osemthethweni	REL
yeeyure	POSS09
lwahlukileyo	REL
avela	REL
okufikelela	REL
nobunzululwazi	ADV
amachweba	N06
zokubeka	POSS10
obahlukeneyo	REL
olunempembelelo	REL
kokuhamba	POSS15
yobungakanani	POSS09
yokuqinisekisa	POSS09
neliphakathi	ADV
zamahala	POSS10
nasekunabiseni	ADV
yesigqeba	POSS09
bakamasipala	POSS02
elisisiseko	REL
ezivunyiweyo	REL
abajongene	REL
kwimibutho	NLOC
elibandakanya	REL
njengemisele	ADV
nokuquqela	ADV
olucokiswayo	REL
emithandathu	ADJ04
xinga	V
ezigodukayo	REL
inguquko	N09
oluzidingayo	REL
ye-msa	POSS09
kweenjongo	POSS15
ezakhayo	REL
obuthe	REL
benemidla	N02
lwasemaphandleni	POSS11
ze	CONJ
amabakala	N06
izipho	N08
zezamaxesha	COP
bekhabhinethi	POSS02
kumagosa	NLOC
kopha	V
ezimbalwa	REL
esisezantsi	REL
besemsebenzini	COP
okuphantsi	REL
kona	PROEMP15
wamalungelo	POSS03
kuncinci	COP
ekujoliswa	REL
bobume	POSS14
ityholo	N09
esisesikweni	REL
kwiimali	NLOC
ziinkqubo	COP
libe	COP
kwi-cbp	NLOC
nanako	ADV
abanakho	REL
abaphambi	REL
engafaniyo	REL
se-venn	POSS07
ezinjengophuhliso	REL
khumbula	V
abahlawulwa	REL
mdala	ADJ01
ngokusemtthethweni	ADV
zegunya	POSS10
okuchanekileyo	REL
nevuk'uzenele	ADV
zokuvelisa	POSS10
banomdla	COP
yenqanam	POSS09
nokunxibelelana	ADV
21	NUM
kwiinkampani	NLOC
nezisombululo	ADV
zangakumbi	POSS10
yedolophu	POSS09
xyz	ABBR
aqonde	REL
abafanele	REL
ezenkolo	REL
kwemizuzu	POSS15
iwadi	N09
imeko	N09
okwenziwayo	REL
lweenkonzo	POSS11
uthintelo	N11
omsebenzi	POSS06
ngokugqwethiweyo	ADV
ngowama-2030	ADV
sobudlelwana	POSS07
namasebe	ADV
lwezomthetho	POSS11
ngokufezekisiweyo	ADV
nokuqonda	ADV
zobume	POSS10
bobuphina	COP
nguceba	COP
luphi	POSS11
benolwazi	COP
nezabahlali	ADV
uninzi	N11
nasebrazil	ADV
singundoqo	COP
welizwe	POSS01
neempawu	ADV
kulungelelaniso	NLOC
grogrisa	V
milisa	V
incomekayo	REL
okulungeleleneyo	REL
abamba	REL
elifika	REL
nemiba	ADV
nyanisa	V
ngezimvo	ADV
ngusherry	COP
ileli	N09
ongagqunywanga	REL
oluneekholam	REL
lamaqela	POSS05
kwisicwangciso	NLOC
structures	FOR
ngokungalinganiyo	ADV
olwamkelekileyo	REL
azizisulu	REL
emisiweyo	REL
ezandisa	REL
seenkalo	POSS07
ngomgqibelo	ADV
lwelungu	POSS11
usanda	VAUX
khathaliseka	V
ntshaphantshapha	V
ezi-3	REL
iipasile	N10
obhexesha	REL
begalelo	POSS14
epokotweni	NLOC
yesithuba	POSS09
emfuyo	POSS06
lempilo-ntle	POSS05
imithathu	COP
naphathwa	ADV
yingcinga	COP
ngokuzithandela	ADV
forum	FOR
se-aicdd	POSS07
zomngcipheko	POSS10
iinzuzo	N10
omzi-mveliso	POSS06
nee-	ADV
noluthembekileyo	ADV
ngumdla	COP
kwiarhente	NLOC
oluvayo	REL
phanda	V
kwakho	POSS15
sabathathi-nxaxheba	POSS07
lokuvota	POSS05
kwakwinqanam	ADV
lwe-pms	POSS11
abanamagunya	REL
womgaqo-siseko	POSS03
ezingundoqo	REL
ezisuka	REL
bayo	POSS02
1998	NUM
lide	VAUX
oqhelekileyo	REL
nabeengingqi	ADV
lokuzala	POSS05
amadela-	N06
ecwangciselwe	REL
beka	V
komgangatho	POSS15
&	PUNC
izilungiso	N08
okunezakhono	REL
nemibandela	ADV
zobulunga	POSS10
esezidolophini	REL
ethatha	REL
loqinisekiso	POSS11
ingxoxo	N09
nonks	ADV
umyalezo	N03
ngokunika	ADV
acacileyo	REL
anombuzo	REL
nokulindelweyo	ADV
wenkonzo	POSS01
asingaba	COP
zokuvalela	POSS08
cwecwe	N05
ohlawulela	REL
i-corplan	N09
okucacileyo	REL
nguquko	N09
namalinge	ADV
unobuzaza	COP
ngokungekho	ADV
nonako	ADV
nokumgangatho	ADV
ngxowa-mali	N10
ezinokufuna	REL
uthethwano	N11
ekuhlalwa	REL
abanokuba	REL
sezibonelelo	POSS07
ku-3.2.1	NLOC
kwii-1970	NLOC
benamalungelo	COP
mema	V
esilawula	REL
ezigqwesileyo	REL
kwi'ladder	NLOC
emizini	NLOC
kwimo	NLOC
ibingumnu	COP
ngekomiti	ADV
koqhagamshelwano	POSS15
imbonakalo-mhlaba	N09
singumgca	COP
bentsebenziswano	POSS14
ezivelisa	REL
yokuhlela	POSS09
tsala	V
oluxhasa	REL
uhlahlelo	N11
eziphawuliweyo	REL
masipala	N00
yeprojekthi	POSS09
wedemokrasi	POSS01
ababhaliswe	REL
okwandileyo	REL
elungiselelwayo	REL
ugcino-mali	N11
sadc	ABBR
68	NUM
abayicingayo	REL
elinjengempendulo	REL
iipowusta	N10
kwakunye	ADV
zekapitali	POSS10
kufikelelo	NLOC
zizinto	COP
esona	PROEMP07
yocwangciso	POSS09
ngokucebisana	ADV
ubuhlwempu	N14
esaphukileyo	REL
abawathathayo	REL
veza	V
linoxanduva	COP
khuphela	V
kokunyanzelwa	POSS15
esinganceda	REL
okubhalayo	REL
zalisekisa	V
eyiphutha	NLOC
nokwandiswa	ADV
ziluncedo	COP
zokungavumelani	POSS08
olunzulu	REL
ukhuseleko	N11
linoncedo	COP
ungummameli	COP
kumnxeba	NLOC
nezigidi	ADV
lidela	COP
yomibini	PROQUANT04
embi	ADJ09
naphantsi	ADV
abagqatswa	N02
ngeekhompyutha	ADV
sawo	POSS07
zikawonkewonke	POSS10
kwisango	NLOC
kwilali	NLOC
okuthatha	REL
ayavumelana	REL
ucalucalulo	N11
sesi	POSS07
ezinokuphucula	REL
wokuthatha	POSS03
ngokwexabiso	ADV
mosaic	FOR
abazibandakanye	REL
odla	REL
ama-848km	N06
nangendlela	ADV
kwamacandelo	POSS15
nokuqhutywa	ADV
wokuphila	POSS03
i-hiv	N09
nepolitiki	ADV
wangazela	V
esiphantsi	REL
yokumisela	POSS09
kokhuselo	POSS15
ezinxulunyanisiweyo	REL
ulwalamano	N11
ixabiso	N05
kubemi	NLOC
kokuthethathethana	POSS15
seprojekthi	POSS07
kwemizi	POSS15
enkcubeko	POSS06
elifuna	REL
ezifanayo	REL
ngeenjongo	ADV
weempendulo	POSS03
ezimpompini	NLOC
i-local	N09
ngokwenzanjalo	ADV
kakade	ADV
zombane	POSS08
nokuphumeza	ADV
noluneziqhamo	ADV
mzekelo	N03
ikomitana	N09
ezikhuselekileyo	REL
abavela	REL
lengcaciso-nkqubo	POSS05
e-afrika	POSS06
onxweme	POSS06
awusiso	COP
kakhulu	ADV
usodolophu	N01a
community-based	FOR
yomgaqo-siseko	POSS09
ekubhekiselelwe	REL
edanisayo	REL
ye-municipal	POSS09
ezinokusebenza	REL
hleleleka	V
kumzekelo	NLOC
nokuncama	ADV
organisation	FOR
anoxanduva	COP
ngokumanyana	ADV
ebonakala	REL
abaphathi	N02
bangaba	COP
mfiliba	REL
okulinganayo	REL
ngoxolo	ADV
abafumanekayo	REL
kumba	NLOC
ntsho	IDEO
bezopolitiko	POSS14
neengcongconi	ADV
kuhlelo	NLOC
i-inshorensi	N09
zomgaqo-nkqubo	POSS08
imfuneko	N09
wenkqubela-phambili	POSS03
echazwe	REL
kugqithiso	NLOC
necekethekileyo	ADV
nokuzinxibelelanisa	ADV
acebisayo	REL
lungisela	V
ngexesha	ADV
unemigaqo-nkqubo	COP
iyeyakho	REL
lokuqinisekisa	POSS11
kubunakho	ADVLOC
ezithe	REL
kwisebe	NLOC
programme	FOR
bengamalungu	N06
kwiforam	NLOC
imikhethe	N04
lwamaxesha	POSS11
nabaphendula	ADV
bokucwangcisa	POSS14
ziimali	COP
eziya	REL
ecetyelwa	REL
kwiintsapho	NLOC
kwenyathelo	POSS15
zokusingqongileyo	POSS10
njengomthundezi	ADV
ekukhutshiswana	REL
isithinzi	N07
esezantsi	REL
iminikelo	N04
lwentsimbi	POSS11
kubuganga	NLOC
ebhalwe	REL
yokulawula	POSS04
umelelo	N11
silela	V
pms	ABBR
ekhoyo	REL
ngokwangoku	ADV
entsonkothileyo	REL
ewadini	NLOC
senkqubo	POSS07
namadoda	ADV
sisithintelo	COP
njengomsunguli	ADV
kwezifundo	POSS15
qingqa	V
nekwakhiwe	ADV
awunawo	COP
ziiprojekthi	COP
isibonelelo	N07
sokuthatha	POSS07
yesicwangciso-qhinga	POSS09
be-cbp	POSS02
izikhululo	N08
obuchanekileyo	REL
yoqhankqalazo	POSS09
ngeshedyuli	ADV
bantu	N02
enoshishino	REL
abathengi	N02
onga	V
kunemfundo	ADV
lwexesha	POSS11
apho	CDEMLOC
sisenokuba	COP
neemali	ADV
isicelo	N07
yamacala	POSS09
zokwakha	POSS10
hoya	V
2005	NUM
wama-20	POSS03
inempumelelo	N09
lokukhuseleka	POSS11
hla	V
ozilungiselele	REL
enkulwana	ADJ09
nkcitho	N09
lweemfanelo	POSS11
zozakuzo	POSS10
wowiso-mthetho	POSS03
ngokudityaniswa	ADV
iikhompyutha	N10
ezidibanayo	REL
zesikolo	POSS10
sedolophu	POSS07
abavoti	N02
msa	ABBR
lenkqubo	POSS05
ishushu	COP
olubhetyebhetye	REL
owabo	REL
amaxa	N06
noloyiko	ADV
ongowabo	REL
ezi-7.9	REL
fama	N00
inqanam	N05
zingumjikelezo	COP
leengcebiso	POSS05
kuthintelo	NLOC
gocagoca	V
yonyaka	POSS09
yesithili	POSS09
engumjikelo	REL
neengcambu	ADV
lesithunzi	POSS05
izinto	N10
abakhoyo	REL
obusetyenziswe	REL
siganeko	N07
kwii-cbo	NLOC
yobomi	POSS04
flats	NPP
konyaka-mali	POSS15
nesiyinzuzo	ADV
zinafuthe	COP
idrafti	N09
wona	PROEMP03
zenkxaso	POSS10
wenyanga	POSS03
amandla	N06
ezinobutyebi	REL
we-16	POSS03
nezisisiseko	ADV
(	PUNC
kwangethuba	ADV
oonogada	N02a
lemithetho	POSS05
yimisebenzi	COP
lezibane	POSS05
nonyango	ADV
esikhoyo	REL
eliphantsi	REL
onoxanduva	REL
kubaqeshwa	NLOC
mifuziselo	N04
ngako	ADV
wokwakhiwa	POSS03
phithana	V
yezoqoqosho	POSS09
eziphakamisa	REL
neaids	ADV
lefet	POSS05
yimiba	COP
olufunekayo	REL
iyingxelo	COP
kwezi-1.5	NLOC
lwelindle	POSS11
ngokungaqhelekanga	ADV
agcine	REL
zotyalo-mali	POSS10
kokona	COP
ngentando	ADV
ngokwesithethe	ADV
nokuthathwa	ADV
ezitsha	ADJ08
kwibanga	NLOC
imbuyekezo	N09
wabahlali	POSS03
olwahlukeneyo	REL
lolumano-	POSS11
oluchithwe	REL
enza	V
ecinga	REL
ngokulingana	ADV
cdws	ABBR
nesimbo	ADV
ulixhoba	COP
eziqhuba	REL
yomlomo	POSS09
achievable	FOR
ngamalungelo	ADV
ngobulumko	ADV
oogobityholo	N02a
akuna	COP
nee-arhente	ADV
kwisantya	NLOC
wokulingana	POSS03
inodaka	COP
wokwakha	POSS03
aphambili	REL
nangokunjalo	ADV
olandelwayo	REL
nangokuqinisekileyo	ADV
isiqulatho	N07
mmandla	N03
zomvuzo	POSS10
ezineenkqubo	REL
elinengeniso	REL
sobuhlwempu	POSS07
kwizikhululo	NLOC
afanelekileyo	REL
vandlakanya	V
ka-1998	POSSKA
kuzakuzo	NLOC
olusemaphandleni	REL
private	FOR
neyoqoqosho	ADV
nabanini	ADV
elandileyo	REL
z	ABBR
yokungalingani	POSS04
yebatho	POSS04
avelisayo	REL
bekwanoxanduva	COP
diesika	N00
nokuqosheliswa	ADV
njengomgangatho	ADV
ezicingisisiweyo	REL
gweba	V
ekwenziwa	REL
sokwenzela	POSS07
ezotywe	REL
yimigaqo-nkqubo	COP
lokunqanda	POSS11
nokuzingca	ADV
ulandelelwaniso	N11
mntu	N01
kumtyhi	NLOC
magama	N06
oluthathu	ADJ11
yokuba	POSS09
abanayo	REL
ngoondoqo	ADV
ephawuliweyo	REL
kwamalungelo	POSS15
amaqondo	N06
yindalo	COP
ezimalunga	REL
sifanelekileyo	REL
nokamasipala	ADV
okucothayo	REL
kunempembelelo	COP
kokuphi	COP
ongusihlalo	REL
komsebenzi	POSS15
kwayo	POSS15
10-15	NUM
ingasisiseko	COP
2004	NUM
etanzania	NLOC
phika	V
yeyiphi	COP
ezinzileyo	REL
isini	N07
okuxhobisa	POSS06
yesi-6	POSS09
nenkani	ADV
yokutya	POSS09
eliyidlalayo	REL
njengamaqumrhu	ADV
ukhukuliseko	N11
dayagram	N00
noncedo	ADV
uhambo	N11
yindawo	COP
amcingayo	REL
echongwa	REL
amalungelo	N06
hlala	V
imvisiswano	N09
abasuka	REL
olungabafudukeli	REL
imithetho-siseko	N04
kukukhuthaza	COP
gqama	V
ukusoloko	VAUX
wethu	POSS03
olungele	REL
dlakathekisa	V
obuqhubekekayo	REL
abanezivumelwano	REL
zaliseka	V
umfundi	N01
yakhe	POSS09
yokuphuhlisa	POSS09
lingusihlalo	COP
oluzinzileyo	REL
neenkqubo	ADV
nokuvandlakanya	ADV
lilo	COP
iimbangi	N10
naliphi	ADV
sengxoxo	POSS07
balikhonkco	COP
ngokusesikweni	ADV
labafazi	POSS05
yamazwe	POSS09
nkcukacha	N09
zeziphina	COP
ngo-1994	ADV
abanovimba	REL
buphantsi	COP
bedolophu	POSS02
yegadi	POSS09
buya	VAUX
zekhomishoni	POSS10
state	NPP
ngemeko	ADV
yemizuzu	POSS09
yodwa	PROQUANT09
esaziwa	REL
24	NUM
ohlahlo	POSS06
lokuqwalasela	POSS11
elikhuphisanayo	REL
qokelela	V
komthetho	POSS15
imo	N09
emilambo	POSS06
ngeendidi	ADV
ngabantu	COP
nokuthatha	ADV
lwabiwo	N11
seziphumo	POSS07
dandalaza	V
ngokwezakhiwo	ADV
nokweekomiti	ADV
amadama	N06
lokusetyenziswa	POSS05
nokunikelwa	ADV
uchintsana	N01a
engcono	REL
orayithi	REL
nobonakalayo	ADV
elinika	REL
okubhekela	REL
kwengqesho	POSS15
isekwangumsebenzi	COP
osisikhokelo	REL
abachongwe	REL
zomnye	POSS10
seengxaki	POSS07
kwarhulumente	POSS15
ne-aids	ADV
iinkxukacha	N10
kumbuzo	NLOC
yokugqithisa	POSS09
sethuba	POSS07
ngombono	ADV
igauteng	N09
inemfanelo	N04
wama-30	POSS03
ojonge	REL
gqitha	V
ephikisanayo	REL
olungundoqo	REL
lwenkunzi	POSS11
a.	ABBR
kulondolozo	NLOC
phuma	V
lwenkxaso-mali	POSS11
zobuchule	POSS10
naphambi	ADV
kwimfundo	NLOC
selahle	POSS07
isimo	N07
cpf	ABBR
okulungileyo	REL
kratya	IDEO
obusebenzayo	REL
lwabantwana	POSS11
kwisigidi	NLOC
qamba	V
ye-batho	POSS04
yokuzama	POSS04
lasempumalanga	POSS05
uxhomekeko	N11
lemikhwa	POSS05
nokujonga	ADV
lonyaka	POSS11
abaqhagamshelene	REL
bhekisela	V
eza	REL
nenkolo	ADV
enenkxaso	REL
bendleko	POSS14
imizekelo	N04
ngokubhekiselele	ADV
ziphambukileyo	REL
eveliswa	REL
isicwangiso	N07
likaceba	POSS05
engaphaya	REL
kweembangi	POSS15
esixananazileyo	REL
yimfuneko	COP
enxulumene	REL
!	PUNC
kwimihlaba	NLOC
okufuneka	REL
imfazwe	N09
ezisekelwe	REL
isinyanzeliso	N07
ka-1994	POSSKA
kunamathuba	ADV
iinkcubeko	N10
kuyenye	COP
imozulu	N09
olusekelwe	REL
kobunye	POSS15
unamaqondo	COP
engaphezu	COP
zintathu	COP
olunobundlobongela	REL
enenkathalo	REL
yeetekisi	POSS04
lwenkcitho	POSS11
lizwe	N05
nakulawulo	ADV
owachonge	REL
yabakwizinga	POSS04
akwangoko	REL
ict	ABBR
zedemokhrasi	POSS10
onxibelelana	REL
kumzantsi	NLOC
esihla	REL
yegunya	POSS04
ngokusemthethweni	ADV
baba	COP
zinto	N10
ngalinye	ADV
nengxowa-mali	ADV
lezentlalo	POSS05
ngokutsha	ADV
olunenkathalo	REL
ngokukuko	ADV
nedata	ADV
kwiindibano	NLOC
nawengingqi	ADV
sesibophelelo	POSS07
ngokwenani	ADV
othutho	POSS06
ye-idp	POSS09
kwababewavinjiwe	POSS15
ngoomaziphathe	ADV
aze	VAUX
sokwabiwa	POSS07
nokubambeka	ADV
engqesho	POSS06
90	NUM
ingesiso	COP
okulungisa	POSS06
susa	V
kumanani	NLOC
kukwakumdla	COP
lweziphumo	POSS11
inganempembelelo	N09
ukhetho	N11
lwabafundi	POSS11
ngakumsebenzi	ADV
yenkxaso	POSS09
obuthatha	REL
nothetha-thethwano	ADV
nokuthi	ADV
wenguqulelo	POSS01
okusembindini	REL
kolawulo	POSS15
engekho	REL
lefliptshathi	POSS05
nokugcina	ADV
ngonobangela	ADV
orientations	FOR
kwemithetho	POSS15
locwanciso	POSS05
oluthile	REL
ngeembono	ADV
6	NUM
ngezifundo	ADV
fanela	V
nasekusebenzeni	ADV
ucwangco	N11
siphumo	N07
sophuhliso	POSS07
olusemagxeni	REL
cingela	V
zokunika	POSS10
kwisisombululo	NLOC
esisekelwe	REL
nasekuncediseni	ADV
iintshukumo	N10
ebifuna	REL
neemfuno	ADV
ngaso	ADV
ngamakhosikazi	COP
nezokusingqongileyo	ADV
nezakhiwo	ADV
ku-0.6kg	NLOC
yendlela	POSS09
ma	V
zemibutho	POSS08
nemizuzu	ADV
neyozalisekiso	ADV
yobume	POSS04
elinomsindo	REL
abangaphantsi	REL
anazo	REL
banethuba	COP
xhaxhe	IDEO
qela	N05
olufikelelekayo	REL
nengxoxo	ADV
lamalungu	POSS05
qhubeka	V
uhlanga	N11
sisakhono	COP
bezixeko	POSS02
nampumelelo	ADV
esimanyanisiweyo	REL
yokusekwa	POSS09
kokujonga	POSS15
imilambo	N04
lelona	COP
abanemidla	REL
sezinto	POSS07
zengcinga	POSS10
lwamadoda	POSS11
umthi	N03
i-arhente	N09
lorhwebo	POSS11
funda	V
zasekuhlaleni	POSS10
lokuhlaziywa	POSS11
abanokukhubazeka	REL
luluhlu	COP
olubonakalisa	REL
international	FOR
egqwesileyo	REL
eluluntu	REL
yimfundo	COP
engakanani	REL
yeenjongo	POSS09
obuwele	REL
okunye	CONJ
fa	V
yokufundwa	POSS09
zingaluncedo	COP
ekubanjwe	REL
solwazi	POSS07
nokuqaphela	ADV
abucala	REL
lebakala	POSS05
vuselela	V
yakho	POSS09
ezidityanelweyo	REL
sokuphumeza	POSS07
lokuphumeza	POSS11
kwingqikelelo	NLOC
nakwi-municipal	ADV
imali	N09
nokungowona	ADV
gqibezela	V
iziphakamiso	N08
ezinokuba	REL
kuza	VAUX
kwisiphathamandla	NLOC
esinyithi	POSS06
nasejapan	ADV
kwezithuthi	POSS15
ubusihlalo	N14
2003	NUM
esebenza	REL
lwemizi	POSS11
ekhadini	NLOC
buchule	N14
wephondo	POSS01
lwesingesi	POSS11
eziyiliweyo	REL
isiphumo	N07
lize	VAUX
kwezilinganiso	POSS15
tyhafa	V
olucacisa	REL
zibekhona	COP
analo	COP
civics	FOR
eshiyekileyo	REL
awusayi	VAUX
okubangela	REL
kanti	CONJ
gqiba	V
kwi-logframe	NLOC
enjalo	REL
isikhundla	N07
abefanele	REL
neenguqu	ADV
umkhuseli	N01
nekomiti	ADV
yokutshintshela	POSS04
wamanzi	POSS03
kotyalo-mali	POSS15
kuxolelwaniso	NLOC
yezakhiwo	POSS09
efree	NLOC
ngengeniso	ADV
kumqulu	NLOC
nelama-45	ADV
yayinabahlali	COP
bokhathalelo	POSS14
nayiphina	ADV
sotshintsho	POSS07
imiqobo	N04
xhala	V
obuhlanganisiweyo	REL
khusela	V
nokulingana	ADV
wenkosikazi	POSS03
abadlali	N02
lolosulelo	COP
kothethwano	POSS15
esemonti	REL
phatha	V
luxwebhu	COP
lijelolonxibelelwano	COP
anikeziweyo	REL
obu	CDEM14
bhaqa	V
okwenza	REL
nganye	ADV
sisakuba	VAUX
ngumsebenzi	COP
isizukulwane	N07
ezifezekiswa	REL
ngokungena	ADV
njengegqiza	ADV
njengebalulekileyo	ADV
zetropiki	POSS08
kwenkunkuma	POSS15
yenkxaso-mali	POSS09
ezinezakhono	REL
zemfundo	POSS10
imizamo	N04
umngeni	N03
wocwangciso	POSS03
nephezulu	ADV
zokuqinisekisa	POSS10
ekomit	POSS06
misebenzi	N04
yomdla	POSS04
nxibelela	V
wokucwangcisa	POSS03
umngxuma	N03
ngokuhlangana	ADV
ngeli	ADV
izishwankathelo	N08
nezengingqi	ADV
ye-led	POSS09
sokusebenzisa	POSS07
umva	N03
usapho	N11
endlela	POSS06
izithintelo	N08
kwisixokelelwano	NLOC
ngokuchaseneyo	ADV
ngokwenza	ADV
othintelo-zingxaki	POSS06
chatha	IDEO
linohlahlo-mali	COP
ezinokwenzeka	REL
macandelo	N06
lwevoti	POSS11
kwezicwangciso	POSS15
lokungaphumeleli	POSS05
anyukayo	REL
eludongeni	NLOC
belali	POSS02
inzululwazi	N09
ka-1997	POSSKA
esinabileyo	REL
labantu	POSS05
we-17	POSS03
balo	POSS02
naphi	ADV
kubaniki	NLOC
yitshatha	COP
yezivumelwano	POSS04
nezoyikiso	ADV
hlengahlenga	V
zokhuselo	POSS08
zimbi	COP
njengenxenye	ADV
kwihlabathi	NLOC
abemi	N02
nokuqokelela	ADV
akayomfuneko	COP
lezicwangciso	POSS05
nothutho	ADV
ngabubele	ADV
ezikhutshwa	REL
inethuba	COP
kwe-r1	POSS15
enemithombo	REL
ezichazwe	REL
kumgangatho	NLOC
wemivuzo	POSS03
igunya	N05
nohlelo	ADV
nabaqeqeshwe	ADV
okuphanda	POSS06
kwilahleko	NLOC
engumgca	REL
zogqithiso	POSS10
enokunikwa	REL
kusuku	NLOC
kwezopolitiko	NLOC
onyaka	POSS06
kwisikali	NLOC
zezityalo	POSS10
ezijolise	REL
imbalelwano	N09
lakho	POSS05
kwamana	VAUX
imibutho	N04
olulandelayo	REL
wokuveza	POSS03
wemisebenzi	POSS03
ingentla	REL
together	FOR
okulindelwe	REL
ayifumeneyo	REL
nabahlalilwamaqela	ADV
zinenzuzo	COP
kwabasemagunyeni	POSS15
wentsebenziswano	POSS01
iinkolelo	N10
sokuchaza	POSS07
esenzeka	REL
olusebenzayo	REL
zokukhula	POSS08
iingxowa-mali	N10
ezinokusabela	REL
ngokuqulunqa	ADV
ezoqoqosho	REL
womzantsi	POSS03
yepms	POSS04
lawo	POSS05
yomngcipheko	POSS03
ezithelekisekayo	REL
ngolwalamano	ADV
okunika	POSS06
ngokokubaluleka	ADV
yezaziso	POSS09
ngosebenza	ADV
yobunzima	POSS04
eziphungulweyo	REL
we-hiv	POSS03
akwixabiso	REL
umanejala	N01a
sosuku	POSS07
ehlanganisiweyo	REL
ngamatye	ADV
unxulumano	N11
bekwanengqumbo	COP
oxoxa	REL
kuhlahlo-lwabiwo	NLOC
osasazo	POSS06
kwiingongoma	NLOC
lweenyaniso	POSS11
ngobhengezo	ADV
ezisetyenzisiwe	REL
yipalamente	COP
unegalelo	COP
kwisipolisa	NLOC
iimanyano	N10
mayeza	N06
zezikhundla	POSS10
nemihla	ADV
naba	V
kwengontsi	POSS15
qala	V
neyoluntu	ADV
angqameneyo	REL
ethubeleza	REL
kweelahleko	POSS15
nolawulo	ADV
qaphela	V
wabasebenzi	POSS03
kudidi	NLOC
neenkampani	ADV
nezicwangciso-nkqubo	ADV
ngokuxelelwa	ADV
kwiingingqi	NLOC
responsive	FOR
ezivakalayo	REL
kontrakthi	N00
sabaqulunqi	POSS07
angaphakathi	REL
umchasi	N01
nokhuphiswano	ADV
ngamakhondo	ADV
eziphilayo	REL
unazo	COP
wambi	POSS06
sokuqhuba	POSS07
anobudlelwane	COP
dinga	V
ezenziwayo	REL
lokubonelela	POSS11
sisigaba	COP
egqithise	REL
iye	VAUX
kubutyebi	NLOC
ngokubonisana	ADV
eyenziwayo	REL
-eli	CDEM05
nezigaba	ADV
engxamisekileyo	REL
abaziva	REL
olubonelela	REL
kwisicwangciso-nkqubo	NLOC
kumalungu	NLOC
nentswela-msebenzi	ADV
zamatyala	POSS10
e-aids	POSS06
angakhuphisana	REL
ngokuguqula	ADV
ngexabiso	ADV
ngokubhala	ADV
lwecandelo	POSS11
ezama	REL
kwezobunzululwazi	NLOC
omvuzo	POSS06
qesha	V
elifunekayo	REL
ishishini	N05
uyinkwenkwe	COP
olumiselwe	REL
yezona	POSS09
nangokuqinisekisa	ADV
elongezelelweyo	REL
vala	V
yokuhlaliswa	POSS09
phendula	V
kwangezibini	ADV
ngale	ADV
ngokukhawuleza	ADV
kwimida	NLOC
ingqiqo	N09
loovimba	POSS11
abangabahlali	REL
yamasiko	POSS09
esecaleni	REL
nobunako	ADV
zizimo	COP
oluqhutywa	REL
ngeendlela	ADV
se-cbp	POSS07
echatshazelwa	REL
nezibophelelo	ADV
yokuwina	POSS09
ezikwi-idp	REL
lwebroadband	POSS11
thethelela	V
isimilo	N07
ngokungqongqo	ADV
okufanelekileyo	REL
kwiinjongo	NLOC
zinemfanelo	COP
lwababini	POSS11
ofanayo	REL
kokungenisa	POSS15
mi	V
kwangeli	ADV
public	FOR
nzima	REL
ibalulekileyo	REL
okhuseleko	POSS06
esemthethweni	REL
ngokwesibalo	ADV
we-idp	POSS03
emigceni	NLOC
ezolawulo	REL
nesithandathu	ADV
ababuya	REL
obufuneka	REL
esebenzileyo	REL
engaphambili	REL
olukhululekileyo	REL
sebe	N00
zize	VAUX
olongeziweyo	REL
ngokwandisa	ADV
eliphezulu	REL
intloko	N09
sokonga	POSS07
nomkhuseli	ADV
gadalala	ADV
anganoxanduva	COP
ngokokuba	ADV
nabamaxesha	ADV
bomthonyama	POSS14
isidlo	N07
okwisahluko	REL
esidityanelweyo	REL
abangatshatanga	REL
lwengxowa-mali	POSS11
khona	ADV
okulungiselelweyo	REL
kwemunicipal	POSS15
omnyama	REL
lwasekuhlaleni	POSS11
ii-logframezizintlu	N10
zidla	VAUX
nabemi	ADV
linda	V
ngokwaloo	ADV
lali	N00
labemi	POSS05
nyula	V
kwiimpikiswano	NLOC
mvunyane	N00
ezibalulekileyo	REL
kwisahluko	NLOC
nezezinto	ADV
iziqinisekiso	N08
enogqaliselo	REL
ngokugqithiseleyo	ADV
zentlalo-ntle	POSS10
esifanelekileyo	REL
ebuyiswayo	REL
ebezikade	REL
ngemidla	ADV
aphuhliswayo	REL
nokuphatha	ADV
lwemiba	POSS11
iinguqulelo	N10
imiphetho	N04
emhlophe	REL
olunjengeepaka	REL
ezikhadini	NLOC
zale	POSS10
incwadana	N09
lwe-cbp	POSS11
weentloko	POSS03
ngononophelo	ADV
lulonke	COP
elapha	REL
okanye	CONJ
umalatha-ndlela	N01a
lwezindlu	POSS11
sakhelo	N07
ngumsindo	COP
anobukrelekrele	REL
kwi-0.9kg	NLOC
iivoti	N10
ezingathi	REL
aphakamileyo	REL
ngokukodwa	ADV
kwisinyanzeliso	NLOC
enokwenza	REL
omfanekiso	POSS03
yohlelo	POSS09
elichaza	REL
njengabameli	ADV
ingangamava	COP
kwamashumi	POSS15
wefowuni	POSS03
bakwanxulumanisa	POSS02
emva	NLOC
sokubonelela	POSS07
esisebenzayo	REL
zobudala	POSS08
imbono	N09
kudla	VAUX
yeendleko	POSS09
ezizezona	REL
kwi-pms	NLOC
kulinganiso	NLOC
rhweba	V
namakhosikazi	ADV
guide	FOR
yenye	POSS09
iliso	N05
ebekiweyo	REL
mpumelelo	N09
ogunyazisiweyo	REL
zibonelelo	N08
lama-21	POSS05
ezili-15	REL
ilandelayo	REL
yingqikelelo	COP
malungiselelo	N06
kukaceba	POSS15
ngokukhawulezayo	ADV
obuluqilima	REL
yamanqaku	POSS09
ezicebisayo	REL
nakumashishini	ADV
engamandla	REL
ezinzima	REL
elinyulwe	REL
esichaza	REL
nakwihlabathi	ADV
zimasa	V
obudityanelweyo	REL
lukwasisiphumo	COP
omgaqo-nkqubo	REL
khuseleka	V
iikliniki	N10
yekapitali	POSS09
yonyaka-mali	POSS04
olwenzeka	REL
amayeza	N06
angasebenziyo	REL
silulwahlulelano	COP
kweemali	POSS15
xesha	N05
kokutshintsha	POSS15
ifliptshathi	N09
ngabaniki	ADV
eziyinene	REL
elinesibhozo	REL
zasemzantsi	POSS10
khulelwa	V
abaneenqobo	REL
lwezinto	POSS11
nakuyo	ADV
uneenkcukacha	COP
ngamaphondo	COP
umanyano	N11
ezishwankathelwe	REL
kombutho	POSS15
lokuvakaliswa	POSS05
eyamkelekileyo	REL
awodwa	REL
nokuzalaniswa	ADV
ukuba	CONJ
ngokujolisa	ADV
ngenkqubela-phambili	ADV
okungabikho	REL
losasazo	POSS05
olapha	REL
njengejelo	ADV
wabagqatswa	POSS03
izijekulo	N08
eliqwalaselwe	REL
ngababandakanyekayo	ADV
eziphawulekayo	REL
kulapho	COP
njengemibutho	ADV
ngesixhobo	ADV
kubathunywa	NLOC
ungenelelo	N11
eziyizalisekisa	REL
nakuqulunqo	ADV
elifanelekileyo	REL
asemngciphekweni	REL
ahloniphekileyo	REL
qeqesha	V
zawo	POSS10
esandisiweyo	REL
loqoqosho	POSS11
yokunika	POSS09
iinyaniso	N10
thembeka	V
kwiminyaka	NLOC
babenegalelo	COP
wee-idp	POSS03
bezobugcisa	POSS02
zesindululo	POSS10
okubukulwa	REL
olukwiphepha	REL
bomgangatho	POSS02
ngezimbo	ADV
zothethwano	POSS10
enxulumanayo	REL
esisilumkiso	REL
kwengxaki	POSS15
isahluko	N07
nawezopolitiko	ADV
kutheni	INTER
wewadi	POSS01
babucala	POSS14
akanaxesha	COP
izohlwayo	N08
sukela	V
ncanca	V
oluphilayo	REL
edurban	NLOC
sonxibelelwano	POSS07
awongezelelweyo	REL
oorhulumente	N02a
bokucingela	POSS14
sabanye	POSS07
ngobuso	ADV
njengezinikezela	ADV
ngamafama	COP
ulungiselelo	N11
namaphephandaba	ADV
esilunge	REL
okubakhathazayo	REL
kwalo	POSS15
ngokuphandle	ADV
somsebenzi	POSS07
nokudlulela	ADV
okunokunceda	REL
inyathelo	N05
esi	CDEM07
nee-datha	ADV
esiqinisekisa	REL
kwekomiti	POSS15
usuleleko	N11
ethetha	REL
imithombo	N04
kufunwayo	REL
amacebiso	N06
lulutho	COP
ulwimi	N11
zokuzilandelelanisa	POSS08
elizayo	REL
izibophelelo	N08
ama-4	N06
esifundo	POSS06
landa	V
kwekhulu	POSS15
ngeentetha	ADV
lewadi	POSS05
nabazikhethela	ADV
ngeveki	ADV
.	PUNC
lwemimandla	POSS11
koloni	NPP
wesixeko	POSS03
yesisombululo	POSS09
nokungaziphathi	ADV
enzima	REL
imitheyini	N04
nokwakha	ADV
banina	INTER
lwa	V
ezingakanani	REL
iifama	N10
zeeprojekthi	POSS10
njani	ADV
kungenjalo	COP
zingamaqonga	COP
bheka	V
bale	POSS14
okubonakalayo	REL
papasha	V
lwee-kpi	POSS11
awenza	REL
se-municipal	POSS07
yamalungelo	POSS09
iinguqu	N10
kugayo	NLOC
zokuphanda	POSS10
imibono	N04
ovelisayo	REL
nezona	ADV
ezibhalwe	REL
komgaqo	POSS15
lasekhaya	POSS05
evelisiweyo	REL
kwikhabhoni	NLOC
okufana	REL
iimali-mboleko	N10
njengakumsebenzi	ADV
abasekelwe	REL
unyango	N11
umgqalisela	N03
mikhwa	N04
ngokwezopolitiko	ADV
obuchule	REL
kwabacebisi	POSS15
nembali	ADV
wocalucalulo	POSS01
kokuvota	POSS15
nasekusombululeni	ADV
olandelayo	REL
lexesha	POSS05
nangokungadibaniyo	ADV
kwinkundla	NLOC
osisiseko	REL
kwiiveki	NLOC
manyathelo	N06
nokugqithisa	ADV
beenkonzo	POSS02
labameli	POSS05
ifowuni	N09
bubuncwane	COP
khola	V
negama	ADV
abakuluntu	REL
lukhuselo	COP
eciskei	NLOC
ngorhulumente	ADV
nezakhono	ADV
2.3.2	NUM
namapolisa	ADV
indibanisela	N09
nokuqeqeshwa	ADV
yokomelela	POSS04
lokungahlulwa	POSS11
wemibuzo	POSS03
woxolelaniso	POSS03
ngokuseka	ADV
mithetho	N04
nemithetho-siseko	ADV
ongamela	V
obunengeniso	REL
yeseshoni	POSS09
ngcebiso	N10
kwamashishini	POSS15
nenokubangela	ADV
badla	VAUX
enikezelwayo	REL
okubandakanyayo	REL
yephulo	POSS09
norhulumente	ADV
wothetha-thethwano	POSS03
ekunokunxityelelwa	REL
ahlukana	V
yabanye	POSS04
babengazifumani	REL
lwase-afrika	POSS11
ngokwamacandelo	ADV
elinqwenela	REL
abanalo	REL
kokuphuhlisa	POSS15
sincinci	COP
abanika	REL
nonxulumano	ADV
ophelileyo	REL
ngezakhono	ADV
nebekufuneka	ADV
nabarhwebi	ADV
abachaseneyo	REL
wokwenza	POSS03
lwase-seymour	POSS11
esizwe	POSS06
zizigqibo	COP
ezifundwayo	REL
kwesantya	POSS15
zingaduru	N08
yezamanzi	POSS04
besicwangciso	POSS14
izixokelelwano	N08
azinqwenelayo	REL
zokuwelisa	POSS08
kumaphepha	NLOC
ngxoxo	N09
namanani	ADV
yinjongo	COP
senene	POSS07
ngabemi	COP
okwamadoda	REL
olusisiseko	REL
ngaziphi	ADV
kwiipokotho	NLOC
iziqhamo	N08
ebiveliswe	REL
ngokutikisha	ADV
esokolise	REL
phuhla	V
okukhawulezayo	REL
wezimbiwa	POSS03
kwelesi-3	NLOC
ezilandelayo	REL
kumthetho	NLOC
yeenkcukacha	POSS09
ngeenzuzo	ADV
hlahlo-mali	N00
esinokusetyenziswa	REL
lokuthembakala	POSS05
qonononda	V
bokunyusa	POSS14
nepalamente	ADV
elinjengombutho	REL
yimasincedane	COP
172km2	ABBR
odano	POSS06
ungubani	COP
nasekunyanzeliseni	ADV
obunesiseko	REL
abaphambili	REL
olunjalo	REL
neeprojekthi	ADV
ekhangela	REL
njengamavolontiya	ADV
ziintoni	COP
ngesi	ADV
ingenazo	COP
lwabahlali	POSS11
ezisesikweni	REL
lwangaphesheya	POSS11
yenkunkuma	POSS09
abahlobo	N02
loba	V
ozisebenzisileyo	REL
inxalenye	N09
zeelwimi	POSS10
nemizamo	ADV
nokuthetha	ADV
ovulekileyo	REL
lwemozulu	POSS11
neengqele	ADV
naluphi	ADV
esikummandla	REL
ikhona	COP
nangoxolo	ADV
ndima	N09
kwendleko	POSS15
koxanduva	POSS15
emizi-mveliso	POSS06
enkqubo	POSS06
phikisa	V
esondlo	POSS06
ubukho	N14
thukisa	V
kwizithintelo	NLOC
okuthile	REL
ezingakumbi	REL
e-indiya	NLOC
umkhosi	N03
ngemithetho	ADV
phosa	V
nobunkokheli	ADV
wonikezelo	POSS03
yokhuphiswano	POSS09
lweli	POSS11
kumaqumrhu	NLOC
bamaphondo	POSS02
ezinokukhethwa	REL
elimpopo	NLOC
elandelwayo	REL
ebhunga	POSS06
ekhulwini	NLOC
le-pfma	POSS05
esesandleni	REL
zesicwangciso	POSS10
kunjalo	COP
njengemeko	ADV
edlalwa	REL
efikelelayo	REL
okuhanjiswa	REL
zemida	POSS10
lukwabanegalelo	COP
nakumalinge	ADV
sokuba	POSS07
ekwenza	REL
ingqesho	N09
kwaso	POSS15
ngemvelaphi	ADV
nempembelelo	COP
eluncedo	REL
zisulu	N08
nabantu	ADV
ababhexeshi	N02
ezemigodi	REL
bekubakho	COP
abali-10	REL
ziluthungelwano	COP
abangafihlisiyo	REL
nokuthomalalisa	ADV
basakuba	VAUX
kwi-overhead	NLOC
nqongophala	V
kwamalungu	POSS15
kwendalo	POSS15
ngeyure	ADV
kubekho	COP
lokujikelezisa	POSS11
kusisiseko	COP
nokulungiswa	ADV
ngongquzulwano	ADV
phawu	N00
elijoliswe	REL
nawoshishino	ADV
yimeko	COP
izaziso	N08
kwiiyunivesithi	NLOC
isitena	N07
ezona	PROEMP08
ziintsapho	COP
abamqhelileyo	REL
lemephu	POSS05
angusihlalo	REL
nokulwa	ADV
emeleneyo	REL
oyedwa	PROQUANT01
angaphaya	REL
kumhlaba	NLOC
ngamazwe	ADV
kwimpendulo	NLOC
eyesithathu	REL
nazindleko	ADV
anolwazi	REL
neendleko	ADV
neprojekthi	ADV
nokuzimisela	ADV
oludla	REL
nomdla	ADV
ngenkonzo	ADV
ezifuna	REL
izibhedlele	N08
osekwenziwe	REL
yomgaqo-nkqubo	POSS09
ozifumanayo	REL
mandulo	ADV
guqula	V
engenachaphaza	REL
sezantsi	ADVLOC
ezintandathu	ADJ10
yokujonga	POSS09
ofisi	N00
olusekwe	REL
kwamanzi	POSS15
yamanina	POSS04
zoqeqesho	POSS10
oluyimpumelelo	REL
kweyezithuba	NLOC
olutsha	ADJ11
eziveliswa	REL
nika	V
sinabantu	COP
nokuqwalasela	ADV
lokufundisa	POSS11
ulungelelwano	N11
nobu	ADV
imvumelwano	N09
idolophu	N09
amaphandle	N06
ezidinga	REL
anomsebenzi	REL
umngcipheko	N03
eziphuhlisiweyo	REL
emigaqo-nkqubo	REL
ezingekaqondwa	REL
izindlu	N10
kwamaxabiso	POSS15
lokuchaza	POSS05
elilikhonkco	REL
zeengxaki	POSS08
fudula	V
lulula	COP
iphambili	REL
kwiiwadi	NLOC
eqhelekileyo	REL
olungaphantsi	REL
zarhoqo	POSS10
ezingenabani	REL
elingangqaliswanga	REL
kwirenki	NLOC
zezitalato	POSS10
ezisebenzayo	REL
iingcaciso	N10
kamasipala	POSSKA
pasile	N00
neyeyabantu	ADV
yamafama	POSS04
tshona	V
ngumgaqo-siseko	COP
libakala	COP
lwezifo	POSS11
lokugcina	POSS11
nevumileyo	ADV
ezo	CDEM10
okumandla	REL
naphakathi	ADV
nokufeza	ADV
nolawula	ADV
ayinabunyani	COP
aseburhulumenteni	REL
ezobuchule	REL
yamva	POSS04
zingaphantse	ADV
i-masincedane	N09
abalekayo	REL
ezikwi-municipal	REL
qhuba	V
nokuphosa	ADV
njengooceba	ADV
lweendlela	POSS11
kwintsukaphi	NLOC
kubutsha	ADJLOC
omdala	ADJ01
ugqithiso	N11
eqhubeka	REL
kwendawo	POSS15
iyodwa	PROQUANT09
ngabo	ADV
eziqhutywayo	REL
kumvuzo	NLOC
nommiselo	ADV
oluhleliweyo	REL
gqabaza	V
nokuphawula	ADV
eekomiti	POSS06
ngokungaphelelanga	ADV
inazo	COP
lomjikelo	POSS11
abangadlali	REL
beedolophu	POSS02
bangela	V
lweendibano	POSS11
oluhlelelekileyo	REL
ezintsha	ADJ10
ngokunentsingiselo	ADV
mgangatho	N03
tse	IDEO
ngeyabo	ADV
nomzantsi	ADV
sexual	FOR
luhlobo	COP
njengabasebenzisi	ADV
kengoko	ADV
kubuchule	NLOC
obubobabo	REL
nomxolelanisi	ADV
anomdla	REL
nedayethi	ADV
zokukhulisa	POSS10
zoqinisekiso	POSS10
impembelelo	N09
nakwizibonelelo	ADV
isesamagosa	COP
enenkuthalo	REL
zezimvo	POSS08
bumba	V
kwirandi	NLOC
onzakala	V
buncinci	ADJ14
ukubakho	COP
ezizizibonelelo	REL
oluhlawulelwa	REL
ngemisebenzi	ADV
ezingqinisiseka	REL
sokungafani	POSS07
benkcitho	POSS14
oku	CDEM15
luyimfuneko	COP
seyingasenguwo	COP
njengeqela	ADV
kunganempembelelo	COP
ngokuyithelekisa	ADV
banovakalelo	COP
ineshishini	COP
kumava	NLOC
okuphezulu	REL
participation	FOR
elilanda	REL
kulutsha	ADJLOC
uqwalaselo	N11
wale	POSS03
yamacandelo	POSS04
obaluleke	REL
bebengama-28	COP
ngokukhululekileyo	ADV
omhlaba	POSS06
yahluka-hlukeneyo	REL
nentando	ADV
namacandelo	ADV
okunyusiweyo	REL
abalizi	N02
le-municipal	POSS05
asinampumelelo	COP
ngondiliseko	ADV
nokumela	ADV
abazibeka	REL
yowiso-mthetho	POSS09
ngqala	V
nenjongo	ADV
ye-pms	POSS09
kumthetho-siseko	NLOC
kwiziphumo	NLOC
ezintle	ADJ10
sokwenza	POSS07
yinkqubo-sikhokelo	COP
lwefayibha	POSS11
emagxeni	NLOC
womntu	POSS03
nezamathuba	ADV
afrika	NPP
olude	ADJ11
ihlaba	N05
yamaxesha	POSS04
ziindawo	COP
akhoyo	REL
nesixokelelwano	ADV
zezicwangciso	POSS10
ezopolitiko	REL
ipropati	N09
lesibini	POSS05
liba	COP
ongekho	REL
lwebhunga	POSS11
nomonakalo	ADV
lwemigaqo-nkqubo	POSS11
umgqithisi	N01
eyiyeyayo	REL
ezandleni	NLOC
oquka	REL
kukhuseleko	NLOC
bukarhulumente	POSS14
olukhulayo	REL
kwizibonelelo	NLOC
iimali	N10
abe	COP
olubandakanya	REL
renta	V
semini	NLOC
layisha	V
nangobuqabane	ADV
logama	ADV
nobubi	ADV
kwala	POSS15
kangaphi	ADV
ezinye	ADJ10
yolo	POSS09
ngesithuba	ADV
ubuqabane	N14
kubahlalimalunga	NLOC
kulwimi	NLOC
yamaziko	POSS09
nangobume	ADV
nempuma	ADV
abantwana	N02
ngokwemfuneko	ADV
amatye	N06
asesikweni	REL
okukumsinga	REL
okulingana	REL
nemiqobo	ADV
ngamashishini	ADV
oluxhaswa	REL
namathuba	ADV
kwinqanaba	NLOC
yempumezo	POSS09
asokolayo	REL
ngumkhokeli	COP
enazo	REL
i-luckytown	N09
thelekelela	V
ebandakanya	REL
zokuqeshwa	POSS08
izahluko	N08
obamba	REL
yinkcazo	COP
esinjenge-overhead	REL
obuhlwempu	POSS06
umphulaphuli	N01
neengeniso	ADV
ngokwemo	ADV
obalulekileyo	REL
thuma	V
saze	VAUX
ezisetyenzisiweyo	REL
sokulandela	POSS07
ne-salga	ADV
sokufaka	POSS07
dika	V
elaneleyo	REL
ka-1995	POSSKA
zeemeko	POSS10
ezivelisayo	REL
;	PUNC
nasekomeleleni	ADV
obenziwa	REL
esikumgangatho	REL
kakhulwana	ADV
kwinani	NLOC
ezahluka-hlukeneyo	REL
isigaba	N07
esisiseko	REL
yenxaxheba	POSS09
ngamadoda	ADV
esenzelwe	REL
neentsapho	ADV
hlangana	V
nabasebenza	ADV
kurhwebo	NLOC
kumelwe	VAUX
sokuhamba	POSS07
zala	V
nobungqina	ADV
abaniki	N02
yokungabikho	POSS04
okuvelisayo	REL
kunyulo	NLOC
lwesini	POSS11
inkcitho	N09
ephuculweyo	REL
ebonwa	REL
ngoya	ADV
usingaye	N01a
awahlawulwa	REL
yoncedo	POSS09
zemali	POSS08
kuxanduva	NLOC
kwizantya	NLOC
udlamko	N11
luye	VAUX
uyimpendulo	COP
neentsingiselo	ADV
ngotshintsho	ADV
nokubanga	ADV
ebehlelelekile	REL
zezimali	POSS10
nokuva	ADV
yayisisithili	COP
ubumbi	COP
noluzisa	ADV
weeprojekthi	POSS03
nasemva	ADV
beenkozo	POSS02
neyentlalo	ADV
iya	VAUX
ebambekayo	REL
ezibanzi	REL
owabiwayo	REL
ezifanele	REL
zemfuduko	POSS10
nokuxhobisa	ADV
nokuthethathethana	ADV
sodwa	PROQUANT07
ekuthe	REL
hiv	ABBR
norulumente	ADV
nokutshintsha-tshintsha	ADV
eziqokelelwe	REL
zethu	POSS10
ngokuvunyelwene	ADV
boorhulumente	POSS14
zehlabathi	POSS10
fet	ABBR
olunjengokoyika	REL
iziqu	N08
masebe	N06
ayiyi	VAUX
mfuno	N09
abangabanxibeleli	REL
amabanga	N06
ngebali	ADV
njengamalungu	ADV
kwiipowusta	NLOC
ngezindululo	ADV
lwemephu	POSS11
kuphengululo	NLOC
ezingenabugoci-goci	REL
neenqobo	ADV
oluhlala	REL
obuyintlaninge	REL
namalungu	ADV
sobujoni	POSS07
anikezele	REL
yomsebenzi	POSS09
msp	ABBR
ngokwengqesho	ADV
kwesicwangciso	POSS15
ngesigqibo	ADV
tshintsha	V
nama-80%	ADV
yeeteksi	POSS09
enako	REL
njalo	ADV
esisisigxina	REL
zokungalingani	POSS08
ngabaqhathi	COP
esinemikhondo	REL
sitsha	ADJ07
oyika	V
zeearhente	POSS10
exabisekileyo	REL
aneengqiqo	REL
ongasemva	REL
sohlahlo	POSS07
kwezifo	POSS15
projekthi	N00
ngobomi	ADV
ezakho	REL
ngokwahluka	ADV
nemizi	ADV
nyamezela	V
bonelela	V
seka	V
nokukhonza	ADV
batho	NPP
nakuzo	ADV
evezwa	REL
yokutshintsha	POSS09
iimvelaphi	N10
imiyalelo	N04
mizi-mveliso	N04
ezinokwenziwa	REL
lweewadi	POSS11
athi	REL
nxiba	V
ezinokusetyenziselwa	REL
uvimba	N01a
leenkonzo	POSS05
yokuqala	POSS09
ngonyaka	ADV
ndlebe	N09
sobulungisa	POSS07
wangaphandle	POSS01
yesiphumo	POSS09
zikarhulumente	POSS10
kwiirhafu	NLOC
ekunokwenzeka	REL
yemithetho	POSS09
ngokwejiyografi	ADV
amathathu	ADJ06
akhe	POSS06
eempepha-mvume	POSS06
ngokwengiqo	ADV
kwawaphi	ADJLOC
khululeka	V
elisezantsi	REL
iminyaka	N04
zokusekwa	POSS08
[	PUNC
awaphi	REL
weengingqi	POSS01
ubuncinane	ADJ14
weveki	POSS03
tyelela	V
ipms	N09
ekwenzayo	REL
ukungabinakhethe	N15
ongowona	REL
umthambo	N03
zedatha	POSS08
esesikweni	REL
ubandakanyo	N11
lakhe	POSS05
kwelama-92	NLOC
inegunya	COP
kwiziko	NLOC
kumalinge	NLOC
nceda	V
namagunya	ADV
kogqithiso	POSS15
nokuphakanyiswa	ADV
esiza	REL
kwidolophu	NLOC
esiseka	REL
kabutsha	ADV
ziikomiti	COP
lulwahlulelwano	COP
obugcinakalayo	REL
bube	COP
ngolimo	ADV
mingeni	N04
basefama	POSS02
kwimveliso	NLOC
zibenoxinezelelo	COP
olunjengephepha	REL
yamatye	POSS09
nengqiniseko	ADV
ezivenkileni	NLOC
izalathiso	N08
ya	V
lwabucala	POSS11
zohlahlo-mali	POSS10
eziqinisekisa	REL
zezicwangciso-buqili	POSS08
soqulunqo	POSS07
nolungenamkhethe	ADV
ubuzaza	N14
amaqonga	N06
akho	POSS06
esibandakanya	REL
lophuhliso	POSS11
nokusetyenziswa	ADV
wamalahle	POSS03
zamakhosikazi	POSS10
abaphilayo	REL
ejoliswe	REL
abawenzayo	REL
elinganayo	REL
yenguqulelo	POSS09
neyexesha	ADV
qaqamba	V
eyelelanayo	REL
ucebawewadi	N01a
bengabikho	COP
ezalanayo	REL
konikezelo	POSS15
kawonke-wonke	POSSKA
woxanduva	POSS03
lokunika	POSS05
ezincinci	ADJ08
anamanzi	REL
yimizi	COP
wesizwe	POSS03
abenegalelo	REL
esebenziseka	REL
kwempompo	POSS15
kubudala	ADJLOC
yejiyografi	POSS09
lulwimi	COP
abazifunayo	REL
engentlanga	ADJ09
yabacebisi	POSS09
umbono	N03
nephepha	ADV
engqondweni	NLOC
ngokufuna	ADV
imfuyo	N09
olumisela	REL
egcinakalayo	REL
zazuzwa	POSS10
eyaphukileyo	REL
yokunyuswa	POSS09
sika	V
olulandeliswayo	REL
nasekutyeni	ADV
kwigalelo	NLOC
nezisekwe	ADV
iimpahla	N10
nini	ADV
abanawo	REL
nakwiimodeli	ADV
fundekela	V
nababandakanyekayo	ADV
azisoloko	VAUX
yomthetho	POSS04
ngqina	V
we-cbp	POSS01
elibhaliweyo	REL
ezinjengee-orenji	REL
ezikwiphepha	REL
nemvume	ADV
e-gep	POSS06
kwentlalo	POSS15
lwamalungu	POSS11
ze-idp	POSS10
abayiqonda	REL
incutshe	N09
i-ajenda	N09
kuneendleko	COP
aye	VAUX
isigqibo	N07
inengxelo	COP
kumzobo	NLOC
labahlali	POSS05
sasemaluti	POSS07
abacebisi	N02
iishifti	N10
nootitshala	ADV
nombane	ADV
nomhla	ADV
njengendawo	ADV
kwezemali	NLOC
yokubonelela	POSS09
lwempahla	POSS11
luvakalelo	COP
nangokufanelekileyo	ADV
nenguqu	ADV
lolungelelaniso	POSS05
labanikezeli	POSS05
kwemifuziselo	POSS15
besixeko	POSS14
olunganonophelwanga	REL
yokhuseleko	POSS04
anela	V
ahluka-hlukeneyo	REL
axhamlayo	REL
qhawuka	V
inkolo	N09
ye-cdm	POSS09
yaso	POSS09
i-cbp	N09
sokutyhola	POSS07
ezidibeneyo	REL
nokuqondwa	ADV
nemateriyali	ADV
nesinotshintsho	ADV
kwibhodi	NLOC
liyindlela	COP
nooceba	ADV
yeklabhu	POSS09
osisityebi	REL
njengendlela	ADV
ephatha	REL
liphela	COP
iyinxalenye	N09
nokutshintshiselana	ADV
sahluko	N07
inguqu	N09
wodliwano-ndlebe	POSS01
iziganeko	N08
ngonikezelo	ADV
bhengeza	V
ngqo	IDEO
wexabiso	POSS03
uvavanyo-zimvo	N11
eso	CDEM07
kokufunyenwe	POSS15
aba	V
ugcinakalo	N11
nommi	ADV
zababhexeshi	POSS08
eya	REL
cazulula	V
kwabasebenzi	POSS15
ngokuyimfihlo	ADV
lwentlalo	POSS11
kotywala	POSS15
iinkcukacha	N10
bebuhlungu	COP
ingakumbi	ADV
zamaqela	POSS10
lunoxanduva	COP
kwesicwangciso-nkqubo	POSS15
ingcaciso	N09
umbane	N03
kubugcisa	NLOC
lwesinizi	POSS11
kwenani	POSS15
sokugqibela	POSS07
anqwenelekayo	REL
kwesikhundla	POSS15
ezolimo	REL
iimpompo	N10
okubandakanyeka	REL
kwesigqibo	POSS15
kwigazethi	NLOC
nobunzulu	ADV
uluntu	N11
yesantya	POSS09
nokukholelwa	ADV
elinokusetyenziswa	REL
labo	POSS05
semfuno	POSS07
olwabiweyo	REL
angena	REL
sayo	POSS07
ngamashumi	COP
ngokolungiselelo	ADV
ethi	REL
zeewadi	POSS10
abuthathaka	REL
bangenalizwi	REL
ngakumbi	ADV
nxulumana	V
ngolwaphulo-mthetho	ADV
owayamene	REL
eli-15	REL
esekwe	REL
umdla	N03
uhlalo	N11
kwenkxaso-mali	POSS15
neembono	ADV
ulangazelelo	N11
obuqhubeka	REL
nakuhlobo	ADV
intlaninge	N09
3	NUM
obupheleleyo	REL
zomthonyama	POSS10
ezonganyelweyo	REL
ekuya	REL
oluseluxolweni	REL
ngumasipala	COP
sokubekwa	POSS07
zininzi	COP
abathweswa	REL
noyilo	ADV
nobudlelwane	ADV
yemiba	POSS04
esondelelene	REL
nzuzo	N09
emxhelo	REL
ebonelelwa	REL
kwaza	VAUX
yoomama	POSS09
zamaxabiso	POSS10
se-msa	POSS07
lahleka	V
lukarhulumente	POSS11
okumameleyo	REL
inkqubela-phambili	N09
kwiingxaki	NLOC
uyilo	N11
yengeniso	POSS09
ntsingiselo	N09
neyolungiselelo	ADV
nokukhula	ADV
nempumelelo	ADV
nezithe	ADV
noovimba	ADV
efana	REL
eyingxam	REL
benkqubo	POSS02
imizuzu	N04
unekratshi	COP
ngexa	ADV
ngomyinge	ADV
emazijongwe	REL
yengxoxo	POSS04
ibakala	N05
kwiingcebiso	NLOC
noluthetha	ADV
somzila	POSS07
kwezinto	POSS15
eyiyo	REL
ligalelo	COP
abhalisiweyo	REL
nohlahlo-mali	ADV
olubalulekileyo	REL
yaba	COP
kumkhondo	NLOC
yesigxina	POSS09
inkokeli	N09
abanyulwe	REL
esinamava	REL
yalo	POSS04
zokukhuthaza	POSS10
imihlaba	N04
ngaphambi	ADV
amabhunga	N06
kwesebe	POSS15
yeemanejala	POSS09
enkolo	POSS06
lendawo	POSS05
nezenkcubeko	ADV
okubi	ADJ15
kumajelo	NLOC
phi	INTER
ofikelelayo	REL
ngegqudu	ADV
mimandla	N04
nokunyusa	ADV
lwethu	POSS11
ngeziko	ADV
woomahlulelane	POSS03
neyure	ADV
pack	FOR
mela	V
zentlalo	POSS10
sesikweni	NLOC
zokuxhasa	POSS10
iphephandaba	N05
minqweno	N04
abangengabo	REL
zendlela	POSS10
wowe-1994	POSS03
kunolo	ADV
msindo	N03
angaphandle	REL
ye-cbp	POSS04
wezicwangciso	POSS03
lomnathazwe	POSS11
lokusebenzisa	POSS11
umhlobo	N01
behlabathi	POSS14
ngeenqwelomoya	ADV
umphathiswa	N01
imizi-mveliso	N04
kubabhexeshi	NLOC
ezinokuzinceda	REL
phila	V
yokumiswa	POSS09
boncedo	POSS02
udliwano-ndlebe	N11
umgca	N03
noluvela	ADV
sesicwangciso	POSS07
anyusiweyo	REL
krwela	V
abaqhankqalazi	N02
njengendima	ADV
kwinkalo	NLOC
iso	N05
ezahlukileyo	REL
sokuwina	POSS07
eququzelela	REL
ephawula	REL
iimbambano	N10
zungu	NPP
ngocalucalulo	ADV
yokunciphisa	POSS09
bokunika	POSS14
nokuhanjiswa	ADV
zohlahlo-lwabiwo-mali	POSS10
kwisikhululo	NLOC
uluvo	N11
nowama-2010	ADV
olwalunenjongo	REL
omtsha	ADJ03
kungasisixhathiso	COP
norhwebo	ADV
seenzuzo	POSS07
nombuzo	ADV
kubantwana	NLOC
elilungileyo	REL
zibe	COP
njl-njl	ABBR
kwisondlo	NLOC
linendima	COP
lixa	N05
yoqhagamshelwano	POSS09
zohlahlo-lwabiwo	POSS10
nabaya	ADV
ezikolweni	NLOC
zabameli	POSS10
ngecwecwe	ADV
nesithuba	ADV
zabemi	POSS10
sakhe	POSS07
naxa	ADV
lukazwelonke	POSS11
esicacileyo	REL
iziphumo	N08
iidolophukazi	N10
yombono	POSS09
uhlahlo-mali	N11
inkxalabo	N09
zamanzi	POSS10
kokuhlanganisa	POSS15
ngokushunqulelwa	ADV
zophuhliso	POSS10
ngoyilo	ADV
ovelisa	REL
ngokugcina	ADV
oluxinanisiweyo	REL
iinkokheli	N10
umzantsi	N03
wasendle	POSS03
sezifundo	POSS07
yokubonakalisa	POSS09
onobunakho	REL
isicwangciso-buqili	N07
umba	N03
kweekholam	POSS15
leenkqubo	POSS05
kumxolelanisi	NLOC
lwalo	POSS11
amanye	ADJ06
lukawonkewonke	POSS11
abanqwenela	REL
ngokuyimpumelelo	ADV
se-12	POSS07
lokushicilela	POSS05
ngaphantsi	ADV
yokuzenzela	POSS09
endlwini	NLOC
hlonipha	V
esintlangothi-ninzi	REL
lokubonisa	POSS05
nokuphakamisa	ADV
kuma-64	NLOC
nemingeni	ADV
ye-wid	POSS09
ngezakhiwo	ADV
ngokukhangela	ADV
lwakhe	POSS11
elungileyo	REL
zixhobo	N08
yezimvo	POSS09
ulawulo	N11
ngokunxulumene	ADV
sisicwangciso	COP
abalawula	REL
gxininisa	V
nasebuseleni	ADV
luxanduva	N11
arnstein	NPP
olubhekise	REL
kwisiseko	NLOC
ngamxhel'omnye	ADV
elisuka	REL
lisebe	COP
kwamadlelane	POSS15
,	PUNC
sokuphatha	POSS07
lohlalutyo	POSS05
elibalekayo	REL
okujamelana	REL
nenqanaba	ADV
eshushu	REL
kwamaziko	POSS15
lwabaniki	POSS11
uzinzo	N11
uthetha-thethwano	N11
ngembuyekezo	ADV
langowama-2008	POSS05
konxibelelwano	POSS15
nomjikelo	ADV
kancinane	ADV
yankulu	ADJ09
langamaqonga	CDEM05
babengalungiselelwa	REL
kweempembelelo	POSS15
mka	V
odlulileyo	REL
zokumisa	POSS10
nize	VAUX
ecaleni	NLOC
sabo	POSS07
nguwo	COP
lwenkonzo	POSS11
imakgotla	N09
kangangoko	ADV
boqoqosho	POSS14
ngokungxamisekileyo	ADV
yematshisi	POSS09
kokukhutshwa	POSS15
sendleko	POSS07
nomahluko	ADV
emadlelweni	NLOC
nokomeleza	ADV
uluhlu	N11
efunyenwe	REL
yendalo	POSS09
zamalungu	POSS10
sisibonelelo	COP
wemisetyenzana	POSS03
koondoqo	NLOC
phonononga	V
kwidemokhrasi	NLOC
anesalathiso	REL
esibhedlele	NLOC
ezigcina	REL
ngamehlo	ADV
ingxelo	N09
legalufa	POSS05
ekhula	REL
yamatyotyombe	POSS09
yingqokelela	COP
namazinga	ADV
ezaphuma	REL
zokugxothwa	POSS10
kwezakho	ADVLOC
nesiqhelo	ADV
ngabasombululi-ngxaki	ADV
ezizezabo	REL
ubutyebi	N14
uthungelwano	N11
bowiso-mthetho	POSS14
yokutyala	POSS09
elichaphazeleka	REL
onabo	REL
koluntu	POSS15
iqabane	N05
zeshishini	POSS10
nokwandisa	ADV
ngebakala	ADV
uyindoda	COP
imfuno	N09
neemveliso	ADV
libazisa	V
okukhenkceza	REL
ii-logframe	N10
leshishini	POSS05
neendlela	ADV
abantsundu	N02
zinendima	COP
ngokungananzanga	ADV
ngokwenkqubo	ADV
thoba	V
zingundoqo	COP
sokuncitshiswa	POSS07
zesenzo	POSS10
esoloko	REL
o-1	REL
kwilekgotla	NLOC
kuqoqosho	NLOC
bani	INTER
usekuhleni	COP
umasipala	N01a
lwesilatini	POSS11
iidayimani	N10
imisebenzi	N04
ngokuvelisa	ADV
weqela	POSS03
buyela	V
komlungelelanisi	POSS15
ngamanyathelo	ADV
kumazwe	NLOC
ngamanzi	COP
ezichaphazela	REL
semngciphekweni	NLOC
ibenoxanduva	COP
bezimali	POSS14
nokwenziwa	ADV
nomsantsa	ADV
yokuthathwa	POSS04
uqeqesho	N11
ozibophelela	REL
uceba	N01a
ngokwasemzimbeni	ADV
esingalungelelananga	REL
kuloo	CDEMLOC
nokumamela	ADV
efuna	REL
nabazimisele	ADV
yolawulo	POSS09
ezinjengempilo	REL
okunxulumene	REL
onika	REL
qhela	V
ngokunikezela	ADV
yalapha	POSS09
ulwamkelo	N11
kwakwithuba	POSS15
izimbiwa	N08
elinomdla	REL
njengamakhaya	ADV
kwi-akhawunti	NLOC
african	NPP
ngokokucukubhede	ADV
sibe	COP
nasekwenzeni	ADV
pheka	V
lungela	V
landelisa	V
elandelelaniswe	REL
abangasebenziyo	REL
kumphathi	NLOC
indima	N09
amaxabiso	N06
ohlukene	REL
iiasethi	N10
ngasinye	ADV
ezinjengengqeshiso	REL
yabahlali	POSS09
ngokunjalo	ADV
elilinganayo	REL
esifuna	REL
yokufumana	POSS09
ngamakhulu	ADV
neengingqi	ADV
yeengcebiso	POSS09
gunyaza	V
lebhunga	POSS05
kunobangela	NLOC
gxotha	V
kunesiphumo	COP
kwi-dplg	NLOC
demarcation	FOR
iinkxaso-mali	N10
esingezantsi	REL
kwenkcubeko	POSS15
zeengxoxo	POSS10
ihiv	N09
okunempumelelo	REL
yitheyibhile	COP
amagama	N06
ngamadoda'elikhoyo	ADV
ziyilaa	COP
sexesha	POSS07
xelela	V
eziphucukileyo	REL
yexokozelayo	COP
salaam	NPP
bonke	PROQUANT02
impendulo	N09
kokuba	POSS15
nokukhokela	ADV
obuninzi	ADJ14
amava	N06
okungacacanga	REL
mxholo	N03
ezingahlawulwa	REL
ngabanezakhono	ADV
imidlalo	N04
kwinto	NLOC
angafaniyo	REL
angaphezulu	COP
wabantu	POSS03
kweklinikhi	POSS15
eyohlukeneyo	REL
nangezikhundla	ADV
ngokuzalwa	ADV
ezikumanqaku	REL
olwahlukana	REL
kumashishini	NLOC
kumfanekiso	NLOC
olungezantsi	REL
njengesixhobo	ADV
kwabameli	POSS15
ngowama-2015	ADV
migangatho	N04
yokubeka	POSS09
ekuvunyelwene	REL
mtsha	ADJ03
kwimakethe	NLOC
ne-youth	ADV
azezona	REL
kwedesika	POSS15
lokunxibelelana	POSS11
ubunakho	N14
obuqhubekayo	REL
onyuliweyo	REL
lokubeka	POSS05
nyina	V
nemifunziselo	ADV
ngokuthatha	ADV
nokubabandakanya	ADV
yi-logframe	COP
bubalulekile	COP
oluncinci	ADJ11
akwi-project	REL
wamagosa	POSS03
zokulungisa	POSS10
yeminye	COP
oluninzi	ADJ11
yayizizo	COP
sokufumana	POSS07
erhola	POSS06
alo	POSS06
enokuthi	REL
se-led	POSS07
sakuba	VAUX
ze-municipal	POSS10
ezinjengolwakhiwo	REL
lomgaqo-siseko	POSS11
olubumbene	REL
ama-20	N06
iinzame	N10
ngxala	V
engama-30	REL
nakuvavanyo	ADV
okulawula	REL
olunyukayo	REL
abalishumi	REL
ubuthunywa	N14
nophuhliso	ADV
enika	REL
oluphucukileyo	REL
imveliso	N09
siso	COP
kweendleko	POSS15
yokulingana	POSS09
angeva	REL
samanyathelo	POSS07
ngenzondelelo	ADV
kwezithintelo	POSS15
yi-dplg	COP
lindela	V
boluhlu	POSS02
okhuthaza	REL
beentlanga	POSS02
malunga	ADV
ephepheni	NLOC
olucwangcisiweyo	REL
cima	V
kuso	PROEMPLOC
yokuphila	POSS09
abalugcwabevu	REL
zahlukeneyo	REL
awekho	COP
zezendlela	COP
ngamaxesha	ADV
kuba	CONJ
angala	REL
ngokwendalo	ADV
imifuno	N04
ezinqwenelekayo	REL
zonikezelo	POSS10
azinamagunya	COP
ezingasondelelananga	REL
lezemigodi	POSS05
iimveliso	N10
nasezidolophini	ADV
neli-15	ADV
isikhokelo	N07
ngumcimbi	COP
ethile	REL
imibandela	N04
zeepatheni	POSS08
nokukhuthaza	ADV
eyakha	REL
abaxabise	REL
noxhathise	ADV
wenkqubo	POSS03
bekuyinjongo	COP
ntweni	NLOC
ziyimiba	COP
abangazisebenzisa	REL
siphela	COP
wokuhlawula	POSS01
iinkampani	N10
ngamaqela	ADV
ezikhethwa	REL
sombulula	V
beqela	POSS02
oluphinda-phindwayo	REL
oyisa	V
njengesikhokelo	ADV
qina	V
ethembekileyo	REL
kweziya	CDEMLOC
njengento	ADV
alungileyo	REL
esintlangothi-ntathu	REL
senxaxheba	POSS07
ngokwesakhelo	ADV
angekho	REL
lunempembelelo	COP
ngokungasebenzi	ADV
obungundoqo	REL
borhwaphilizo	POSS14
nengcebiso	ADV
nangokusebenzisa	ADV
kwenyanga	POSS15
nolwazi	ADV
agunyazisiweyo	REL
integrated	FOR
nesithethi	ADV
omnye	ADJ03
okubonisa	POSS06
emaqeleni	NLOC
zobungakanani	POSS10
lamalungiselelo	POSS05
ludwe	N11
nokufezekisa	ADV
likabani	INTER
zixhaphakileyo	REL
uvakalelo	N11
ngawo	ADV
loomasipala	POSS11
ngocingo	ADV
ngobunjalo	ADV
ngokungalingani	ADV
lokonga	POSS05
yokugqibela	POSS09
impompo	N09
obujongene	REL
ukuze	CONJ
lokuthobela	POSS11
chonga	V
nesebe	ADV
ziiarhente	COP
lamazwe	POSS05
zasemsebenzini	POSS08
ii-kpi	N10
zesebe	POSS10
enokubangela	REL
100	NUM
kunomkhethe	ADV
esibanzi	REL
okoko	ADV
ezingasebenziyo	REL
achaphazeleka	REL
kweenzwane	POSS15
kwizixokelelwano	NLOC
okokugqibela	ADV
awafane	VAUX
zabafundi	POSS10
ndawo	N09
kunongaphantsi	ADV
guquka	V
lulandelayo	REL
ezihlaziywayo	REL
kokulingani	POSS15
sefet	POSS07
eliphetheyo	REL
kubaboneleli	NLOC
ulingano	N11
ngendima	ADV
nolucwangcisiweyo	ADV
ngomgqalisela	ADV
oluqhubekekayo	REL
ezifunyenwe	REL
abanakhredithi	COP
bada	VAUX
asingomsebenzi	COP
nakwezinye	ADV
esikhundla	POSS07
kumakhwenkwe	NLOC
zokufumanisa	POSS10
owenza	REL
le	CDEM04
ezinika	REL
liphezulu	COP
ngokwaneleyo	ADV
amakhosikazi	N06
lusenokungabi	COP
abanesifo	REL
ngezenzo	ADV
njengohlanga	ADV
x	FOR
bembalwa	COP
wakho	POSS03
akhokelela	REL
nabaphathi	ADV
naziphina	ADV
nenani	ADV
kwamalahle	POSS15
awuyi	VAUX
ngokuphuhlisa	ADV
kwiingo	NLOC
nokuqeshwa	ADV
kwelanga	POSS15
ngezihloko	ADV
ngenelela	V
saphakathi	POSS07
no-5	ADV
yeenqobo	POSS04
anobudlelwano	REL
ngokwayo	ADV
lo	CDEM03
emiba	POSS06
lemvelo	POSS05
zezinto	POSS10
ekuphuhliswa	REL
leentsuku	POSS05
eseyenzekile	REL
isigama	N07
lwemali	POSS11
unenjongo	COP
nogunyaziso	ADV
ziyiyo	COP
nezezimvo	ADV
asekuhlaleni	POSS06
5.6	NUM
inako	COP
kwelama-64	NLOC
nee-kpi	ADV
we-15	POSS03
nokukhuphisana	ADV
zokuhlaliswa	POSS08
ngokuphucula	ADV
ezinyanzeliswe	REL
wokusebenzisa	POSS03
nongathi	ADV
ezichanekileyo	REL
yokuya	POSS09
iipotfoliyo	N10
umxholo	N03
qha	ADV
abaza	REL
bumalunga	COP
bamba	V
zineenjongo	COP
oluphantsi	REL
oluhambelana	REL
ngokuphilileyo	ADV
olunikezelwa	REL
okulamla	REL
unalo	COP
bentlanganiso	POSS14
ibha-tshathi	N09
bokwakha	POSS14
nzulu	REL
lowo	CDEM01
lomsebenzi	POSS11
kwamaqela	POSS15
yeenkcukacho	POSS04
olufana	REL
obungcono	REL
abakwiwadi	REL
lwezi	POSS11
olumandla	REL
lungcono	REL
nxulumena	V
elilodwa	REL
zithathu	ADJ08
nendleko	COP
isithethe	N07
nakwiikholeji	ADV
kweendima	POSS15
igumbi	N05
lesenzo	POSS05
iilamuni	N10
ngokwaso	ADV
kwabafundi	POSS15
i-anc	N09
inkcazelo	N09
ngokwe-idp	ADV
nakwimakgotla	ADV
njongo	N09
zilandelayo	N08
eendabaabahlali	POSS06
unezisongelo	COP
iiteksi	N10
xhoba	V
kwexabiso	POSS15
nesihloko	ADV
oluthi	REL
kwithenda	NLOC
ineengcambu	COP
nakuhlolo	ADV
iphepha	N05
yezopolitiko	POSS04
kungekho	COP
okuthetha	REL
zithintelo	N08
umgaqo	N03
neenkokeli	ADV
azingomaqumrhu	COP
liya	VAUX
elinikezela	REL
abaphuma	REL
boxhomekeko	POSS14
nocwangciso	ADV
ilungelo	N05
dibanisa	V
?	PUNC
shicilela	V
olongezelelweyo	REL
kweziphumo	POSS15
kwimbono	NLOC
lwarhoqo	POSS11
sikazwelonke	POSS07
esinobulungisa	REL
1	NUM
kasodolophu	POSSKA
oluxinana	REL
kwa	ADV
kungathi	COP
ngummi	COP
ngokuqhuba	ADV
umphathi	N01
irenki	N09
kumaqela	NLOC
nokubandakanya	ADV
owayanyaniswa	REL
candelo	N05
esikhulu	ADJ07
ze-led	POSS08
obuqalwe	REL
yawo	POSS04
lwabo	POSS11
nezinakho	ADV
wokwenzekayo	POSS03
isithethi	N07
ngomnye	ADV
adlulileyo	REL
inkuthazo	N09
okujoliswe	REL
enikezelweyo	REL
ngaphaya	ADV
ngokugqibeleleyo	REL
eqela	POSS06
kwezimbini	ADJLOC
elikwaziyo	REL
efunyanwayo	REL
kacaba	POSSKA
unolwazi	COP
ngokwazeka	ADV
amaplanga	N06
nongenelelo	ADV
namaziko	ADV
ezizuzisa	REL
zikolo	N08
njl.	ABBR
ezilondolozekayo	REL
ezicukula	REL
iiyure	N10
igazethe	N09
okuqeshwa	POSS06
ngumgangatho	COP
yezobuchule	POSS09
ummi	N01
ngazwi-nye	ADV
lumla	V
zingaba	COP
nokuvuza	ADV
eziyimijikelo	REL
kwezimali	POSS15
ngohlengahlengiso	ADV
yokwanda	POSS09
lwaseafrika	POSS11
yesipolisa	POSS09
emele	REL
ebalulekileyo	REL
yezikhomishoni	POSS09
njengokulungiswa	ADV
ngokufumana	ADV
kocalucalulo	POSS15
kuqhankqalazo	NLOC
abangayilindela	REL
yesixokelelwano	POSS09
lokuvukela	POSS05
ongquzulwano	POSS06
zinentsingiselo	COP
olula	V
kwiqondo	NLOC
ezithunyelwa	REL
nakuvelisayo	ADV
kwiofisi	NLOC
egqithileyo	REL
nezakhelo	ADV
kwi-ofisi	NLOC
ubukhulu	N14
dla	V
yesininzi	POSS04
kwamaqondo	POSS15
basebenzayo	REL
ikhondo	N05
zowiso-mthetho	POSS08
zokusebenza	POSS10
isixokelelwanlo	N07
zabathathi-nxaxheba	POSS10
yokuvavanya	POSS09
nakwiqela	ADV
yebhayoloji	POSS09
emide	ADJ04
nohlahlo	ADV
gagana	V
nokuthoba	ADV
awumhlanga	COP
othungelwano	POSS06
wama-60	POSS03
ezinikelwa	REL
ngokwenzekayo	ADV
ucoceko	N11
isizathu	N07
sentshonalanga	POSS07
oluchaphazela	REL
norhwaphilizo	ADV
ezibangelwa	REL
kwingxelo	NLOC
sale	POSS07
esuka	REL
ngelinge	ADV
yelizwe	POSS09
yoogoba	POSS09
benkxaso-mali	POSS02
amatyathanga	N06
ucebaukuze	N01a
lwedijithali	POSS11
iyise	N09
banemingxuma	COP
abathengisayo	REL
basebloemfontein	POSS02
kubavelisi	NLOC
ye-stokvel	POSS09
abeyimpumelelo	REL
kweeprojekthi	POSS15
elisebenza	REL
amazwi	N06
kukulo	COP
hluma	V
zabathengi	POSS08
julayi	N00
league	FOR
umzekelo	N03
nakwiinkonzo	ADV
yamakhosikazi	POSS09
nokusekwa	ADV
zibalulekileyo	REL
esicwangcisiweyo	REL
yeengxoxo	POSS09
elisebenzisana	REL
koovimba	POSS15
zodwa	PROQUANT10
nelungelo	ADV
kwazo	POSS15
njenge-section	ADV
olumalunga	REL
zoluntu	POSS10
umongameli	N01a
eyeyona	REL
kumana	VAUX
ezirheshiweyo	REL
thomalala	V
bemihla	POSS02
bobuphi	COP
kuphicotho	NLOC
isenokuba	COP
zeziphumo	POSS08
ngokubaluleka	ADV
ngohlahlo	ADV
uqhankqalazo	N11
nosapho	ADV
kazwelonke	POSSKA
siya	VAUX
ngokomsebenzi	ADV
zemimiselo	POSS08
eziphambili	REL
mayibe	VAUX
aveza	REL
bobugcisa	POSS14
nomzekelo	ADV
makabe	VAUX
okuninzi	ADJ15
yingxelo	COP
yingqesho	COP
ongcono	REL
lokusungula	POSS05
kanobhala	POSSKA
ii-arhente	N10
esiba	REL
khangela	V
emithathu	ADJ04
nakumoya	ADV
abasaphilayo	REL
nokuhlaziywa	ADV
ingengawo	COP
chintsana	N00
abancedisi	N02
ngolwazi	ADV
ezifunyaniswe	REL
nemicimbi	ADV
ppp	ABBR
zolawulo	POSS10
bolwaphulo-mthetho	POSS14
ngekhilowathi	ADV
sombane	POSS07
njengeziko	ADV
nangendawo	ADV
okumandundu	REL
aids	ABBR
edolophini	NLOC
namagingxigingxi	ADV
ababanyulileyo	REL
etshayina	NLOC
nokubanemveliso	ADV
fumba	V
esisayiniweyo	REL
ne-cbp	ADV
lwaphulo	POSS11
iingxaki	N10
isixhobo	N07
nokuqulunqwa	ADV
ngokushiya-shiyaniswa	ADV
kwezenzo	POSS15
size	VAUX
zemozulu	POSS08
yopolitiko	POSS09
yebhola	POSS09
olugcinakalayo	REL
newadi	ADV
namashishini	ADV
i-afrika	N09
unks	N01a
nakanjani	ADV
yasezidolophini	POSS09
nemizi-mveliso	ADV
oluqaphelayo	REL
iimephu	N10
ayingomnikeli	COP
beleka	V
ezesini	REL
ezihlelelekileyo	REL
nesimiselwe	ADV
ziinkalo	COP
ezilungiselelwe	REL
yangaphandle	POSS04
ingxam	N09
eziluncedisayo	REL
esithathwini	ADVLOC
ngokwee-idp	ADV
ezenzekayo	REL
kokulingana	POSS15
kuyilo	NLOC
hlanganisela	V
eziqokelelweyo	REL
usihlalo	N01a
kwerekhodi	POSS15
isuti	N09
ubudlelwane	N14
singentla	REL
elingaphambili	REL
sesakhiwo	POSS07
linganisa	V
zeekomiti	POSS10
kwebhunga	POSS15
egunyazisiweyo	REL
zizahluko	COP
inkxaso-mali	N09
lokuvelisa	POSS05
vutha	V
biza	V
bokubhala	POSS02
nokungalingani	ADV
yokukhuthaza	POSS09
uhlahlo-lwabiwo	N11
langaphambili	POSS05
ezigadini	REL
inkosikazi	N09
kwisazobe	NLOC
nalapho	ADV
lama-87	POSS05
olusezantsi	REL
abunabulungisa	COP
anyule	REL
babahlali	POSS02
necandelo	ADV
lamaziko	POSS05
wehlabathi	POSS03
umgaqo-siseko	N03
unikeza	N01a
neerhafu	ADV
ngo-2030	ADV
ze-kpi	POSS10
bebonke	COP
ezibekwe	REL
neempembelelo	ADV
evekini	NLOC
nangengqiqo	ADV
ezongeziweyo	REL
longquzulwano	POSS11
lwehlabathi	POSS11
iiyunivesithi	N10
ngogunyaziwe	ADV
kwiingxowa-mali	NLOC
bokubhexesha	POSS14
ingeniso	N09
kwimiqathango	NLOC
zokukhubazeka	POSS10
ephuhlise	REL
nokusebenzayo	ADV
nguye	COP
ngemephu	ADV
lokungaguquguquki	POSS05
eyenzekayo	REL
wengingqi	REL
kumnathazwe	NLOC
izigqibo	N08
ezihanjisiweyo	REL
ngokufikelela	ADV
uphambili	COP
sokumisela	POSS07
ngokubanzi	ADV
mhle	COP
opolitiko	REL
qho	IDEO
ubudlelane	N14
nangoomasipala	ADV
entlanganisweni	NLOC
namava-ngamava	ADV
zakho	POSS10
ikhethe	N05
lokwenza	POSS05
zokuhanjiswa	POSS10
ngee-idp	ADV
obulolo	REL
kuvandlakanyo	NLOC
nenkonzo	ADV
olusesikweni	REL
kwikhaya	NLOC
e-united	NLOC
bemeko	POSS14
sikanomathotholo	POSS07
ngxelo	N09
ezomthonyama	REL
chana	V
isambuku	N07
empembelelo	POSS06
lama-66	POSS05
angqiniweyo	REL
mjikelo	N03
ngokwamabakala	ADV
unezinga	COP
abanikezela	REL
edongeni	NLOC
lokuxoxa	POSS05
ngokwedemokrasi	ADV
zizindululo	COP
unkz	N01a
kukungalingani	COP
yokufezekisa	POSS09
kwii-pms	NLOC
izimbo	N08
nokudityaniswa	ADV
kwesixokelelwano	POSS15
kweenkalo	POSS15
phepha	N00
ibroadband	N09
ngokulungiswa	ADV
yeenzuzo	POSS09
iikhadi	N10
nezimbini	ADV
zokuphuhlisa	POSS08
zokuvavanya	POSS10
basenokuziva	N02
sikamasipala	POSS07
yabazali	POSS09
kwiqonga	NLOC
nyamalela	V
webatho	POSS03
abanolwazi	REL
uthethwathethwano	N11
xabisa	V
kwisithathu	ADJLOC
okubangqongileyo	REL
elinyiniweyo	REL
kwiidolophu	NLOC
ingqondo	N09
intengiselwano	N09
okungalingani	REL
sayina	V
nyanzela	V
ingcinga	N09
iklasi	N09
obuquka	REL
nasegauteng	ADV
angaquka	REL
zokufumana	POSS10
ngusihlalo	COP
kumalungiselelo	NLOC
eofisini	NLOC
esilandelayo	REL
ngokungathi	ADV
yomkhuseli	POSS09
kufakelo	NLOC
ngebala	ADV
dala	V
ngentelekelelo	ADV
njengefanelekileyo	ADV
nendlela	ADV
ubungcali	N14
andula	V
yokuzinceda	POSS09
imigangatho	N04
esiwayo	REL
zibenegalelo	COP
zokulungiselela	POSS10
olufuna	REL
babenoxanduva	COP
nolwimi	ADV
yesicwangciso	POSS09
kudushe	NLOC
kubalawuli	NLOC
okucetywayo	REL
esifana	REL
ongezempilo	REL
nokufa	ADV
kungaphantse	ADV
lezandla	POSS05
oluqinisekisa	REL
ye-sdip	POSS09
ezijongene	REL
enodaka	REL
thintela	V
lovavanyo	POSS11
nokungafani	ADV
i-sanco	N09
engafanelekanga	REL
the	FOR
komitana	N10
nakwiintlanganiso	ADV
kwiilokishi	NLOC
umbutho	N03
lomxholo	POSS05
yokuqalisa	POSS09
babengamafama	COP
olwaziwayo	REL
ngokulinganayo	ADV
kwabemi	POSS15
yindlala	COP
kurhulumente	NLOC
ezineengcambu	REL
nemibono	ADV
komnye	ADJLOC
ngokwezinto	ADV
jikelele	ADV
kwiqalela	NLOC
izingqinisiso	N10
shiya	V
ngokwahlukileyo	ADV
ku-1.2	NLOC
yokumamela	POSS09
na	INTER
ababelana	REL
okwenziwe	REL
elixhasa	REL
zigqibo	N08